4H0975000AXLG	Coverall Insulated-Tall-BRN-X Large                                                                  
4H7546000AMED	Hooded Zip Sweatshirt-Black-Medium                                                                   
4J5916000ALRG	Carhartt ArticTrad Coat BLK Tall Large                                                               
4NB76NNBLAXLG	Men's Hooded Sweatshirt - Dog  Black X Large                                                         
4NBFDKNBLBC42	Lilyette  Embellished Keyhole  Black 42 C                                                            
4NBHA3BVRMNGS	Hanes Performance Cotton Regul Navy-Red S                                                            
4NBHA3BVRMNGS	Hanes Performance Cotton Regul Navy-Red S                                                            
4NBHARNWHBB46	Playtex 18 Hour ComfortFlex Se White 46 B                                                            
4NBHH7NWHBD40	Bali Convertible Wirefree Bra White 40 D                                                             
4NBLXZNBLAMED	Stacy Adams Homburg Black Medium                                                                     
4NBUL3NBLMNGL	Lamaze Soft Sleep Maternity Br Black L                                                               
4NBWJENSMA2XL	Hanes MN ComfortBlend EcoSmart Smoke 2XL                                                             
4NBWJENSMA2XL	Hanes MN ComfortBlend EcoSmart Smoke 2XL                                                             
4NBWWONBLMNGM	Hanes Adult Beefy-T Long-Sleev Black M                                                               
4NBWWORLPMNGM	Hanes Adult Beefy-T Long-Sleev Light Pink M                                                          
4NBWWPNBYMNGM	Hanes Men's Nano-T V-Neck T-Sh Black-Gray M                                                          
4NBWWPNGRMNGM	Hanes Men's Nano-T V-Neck T-Sh Gray M                                                                
4NBXA2NBLBY42	JMS Front Close Wirefree Bra Black 42 DDD                                                            
4NBXA4NWHBC42	JMS Active Lifestyle Wirefree  White 42 C                                                            
4ND855NBLAMED	Berne Insultd Coverall - Short Black Medium                                                          
4ND90ENBLAXLG	ML WM Triple Stitch Detailed J Black X Large                                                         
4ND9ZZNBLALRG	Men's Nylon Jacket w/ Black &  Black Large                                                           
4NE024NBRAMED	Berne Insultd Coverall-Regular Brown Medium                                                          
4NE025NBLT2XL	Berne Insulatd Coverall - Tall Black Tall 2XL                                                        
4NE034BLUALRG	Carhartt Hooded Logo Sweatshrt Blue Large                                                            
4NE4UKNBLA2XL	MEN'S SCOOTER JACKET WITH LEAT Black 2XL                                                             
4NE6X2NMLWM2X	Wear Abouts PL-Twist waist dre Multi 2X                                                              
4NEAGSREDA3XL	Plus Size Tie Dye Top/Tunic Red 3XL                                                                  
4NEMKMNBLALRG	WM Rain Suit Water Proof w/ Re Black Large                                                           
4NF90YNOAWM1X	Dantelle PL Button Down Boyfri Oatmeal 1X                                                            
4NFH4XRPKBF42	Glamorise The Ultimate Full Fi Pink 42 DDD/F                                                         
4NFIP3NBLKD5X	Event Lthr MN PLAIN VEST LIGHT Black 5X                                                              
4NFJ0NNBLAMED	Toddlers Traditional Style Motorcycle Black Medium                                                   
4NFJ1TNBLWM2X	ML MEN'S TRADITIONAL DENIM JAC Black 2X                                                              
4NFLI8NBLALRG	EL MEN'S VEST W/ 9 PATCHES Black Large                                                               
4NFLKPNBLASML	EL MEN'S VEST W/ 23 PATCHES Black Small                                                              
4NFMY9NCAALRG	Blair Irvine Park Wool Carcoat Camel Large                                                           
4NGVXSNBLK2XL	PUMA WM T7 SATIN PANT Black XXL                                                                      
4NH98RNCMS080	AX Paris Women's Chiffon Top F Cream 8                                                               
4NHNS9YELS080	Women's Contrast Yellow Floral Yellow 8                                                              
4NHP18AZSP382	Dickies Carpenter Jeans Timber 38W 32L                                                               
4NIC8MNBRP366	Carhartt MN Quilt Ln Zip To Th Brown 36W 36L                                                         
4NIC8MNBRP406	Carhartt MN Quilt Ln Zip To Th Brown 40W 36L                                                         
4NIC8NNBLP366	Carhartt MN Quilt Ln Zip To Th Black 36W 36L                                                         
4NIC8NNBLP382	Carhartt MN Quilt Ln Zip To Th Black 38W 32L                                                         
4NIC8NNBLP442	Carhartt MN Quilt Ln Zip To Th Black 44W 32L                                                         
4NIXIQNBRAMED	Victory Men's Distressed Brown Brown Medium                                                          
4NJ1FNNBLAXLG	Marc NY MS Renee 30" chevron D Black X Large                                                         
4NJ5BONWHS060	Vanity Fair Perfectly Yours Cl White 6                                                               
4NJ5WJNBLBX40	Playtex Secrets Feel Gorgeous  Black 40 DD                                                           
4NJS0BRRBS120	Westside WM Color Block Jacket Red-Black 12                                                          
4NJUCKVKUWM2X	Womens-Batwing Scrunch Dark Plum 2X                                                                  
4NKK40BLUBG36	Soft Shoulders T-Shirt Bra wit Blue 36 G                                                             
4NKK4ONBLAXLG	Outdoor Spirit Ladies Mix Medi Black X Large                                                         
4NKMK5NBLWM2X	Outdoor Spirit Ladies Plus Ful Black 2X                                                              
4NKMLGNBLWB3X	Outdoor Spirit Ladies Plus Mix Black 3X                                                              
4NKMLGNBLWM2X	Outdoor Spirit Ladies Plus Mix Black 2X                                                              
4NKMLHNCAWB3X	Outdoor Spirit Ladies Plus Ful Camel 3X                                                              
4NKTNBNBYBX38	Maidenform Live in Luxe Extra  Black-Gray 38 DD                                                      
4NKTV7NBLOS1X	Women's Plus Size Super- Black One Size Fits 1X-3X                                                   
4NKTV9NBYOS1X	Pack of 3: Women's  Black-Gray One Size Fits 1X-3X                                                   
4NKVMIBRTMNGL	Short Sleeve Horizontal Stripe Bright Blue L                                                         
4NKXD0NPPT2XL	Outdoor Spirit Mens Cotton Jac Copper Tall 2XL                                                       
4NKXD0NPPT2XL	Outdoor Spirit Mens Cotton Jac Copper Tall 2XL                                                       
4NKXD3REDASML	Outdoor Spirit Ladies Faux Woo Red Small                                                             
4NKXD3REDAXLG	Outdoor Spirit Ladies Faux Woo Red X Large                                                           
4NKXDUNGRAXLG	Outdoor Spirit Mens Board Jack Gray/Silver X Large                                                   
4NKXECNBLA2XL	Outdoor Spirit Plus Ladies Sof Black 2XL                                                             
4NKXMBPLEMNGM	Kimball Kids Girls bubble jack Leopard M                                                             
4NKXMGNBLAXSM	Kimball Kids Boy's snow bib Black X Small                                                            
4NKXMGNBLAXSM	Kimball Kids Boy's snow bib Black X Small                                                            
4NL35MNBLS120	AX Paris Women's Turtle Neck K Black 12                                                              
4NL6UVNBLA3XL	Men's Hooded Sweatshirt - Mast Black 3XL                                                             
4NLALQNBLONES	SCALA CTTN BIG BRIM W/INNER DR Black ONE SIZE                                                        
4NLAWCREDWM1X	White Mark Pl 'Sigrid' Top/Tun Red 1X                                                                
4NLNXANSM0010	Reks ST Black Slingblade Frame Smoke                                                                 
4NLNXENSM0010	Reks ST Gray Slingblade Frame  Smoke                                                                 
4NLS0NNBLAXLG	STACY ADAMS FEDORA W/MATCHING  Black X Large                                                         
4NLS1SNBLAXLG	WOOL FELT DIAMOND CROWN Black X Large                                                                
4NM1PCLLCBC42	Elegance Underwire Lace Bra Lilac 42 C                                                               
4NM5T9FSTALRG	NFL Player Full Zip Hoody Steelers Large                                                             
4NM9ASNBLWMML	AX Paris Giant Heart Knit Blac Black M/L                                                             
4NM9SONCTS120	AX Paris Women's Turtle Neck S Chocolate 12                                                          
4NMQ19NBHK2XL	Lucky MN S/S INDIGO DOBBY SANT Black-White XXL                                                       
4NMUPDNBLS120	Women's Capped Sleeve Crochet  Black 12                                                              
4NMVMYBNVAXLG	Whitemark WM Solid Leggings Navy X Large                                                             
4NN06VNCHALRG	LADIES WOOL FUR TRIM HOOD COAT Charcoal Large                                                        
4NN1VKNBLALRG	Nuvano LADIES 3-N-1 SYSTEM JAC Black Large                                                           
4NN2GPRPK03T0	Kimball Kids Girls Board Jacke Pink 3T                                                               
4NN34RNBLGLSM	Nuvano Hat and Glove Fleece Se Black S/M                                                             
4NN4Q0NBLA3XL	PLUS SIZE Rocawear Ladies "Mac Black 3XL                                                             
4NN4Q0TDRA1XL	PLUS SIZE Rocawear Ladies "Mac DARK TAUPE 1XL                                                        
4NN4QNNBLA3XL	PLUS SIZE CWG LADIES VEST Black 3XL                                                                  
4NN4QOVBGAXLG	Rocawear Ladies "Mackage" styl Burgundy X Large                                                      
4NN4RFREDA2XL	PLUS SIZE ROCAWEAR LADIES MEMO Red 2XL                                                               
4NN4RUREDAXLG	RBX LADIES INSULTAED SKI JACKE Red X Large                                                           
4NN4V2RPKKD78	BIG GIRLS USPA FASHION BUBBLE  Pink 7/8                                                              
4NN4VHMNIMNGS	Kenneth Cole WM Puffer w-Faux  Nickel S                                                              
4NN4VKWMNMNGS	KC Wool Jkt w-Faux Fur Trim Co Midnight S                                                            
4NN4VWNIVA3XL	PLUS SIZE STEVE MADDEN LADIES  Ivory 3XL                                                             
4NN52AGOLMNGM	Galaxy By Harvic MN Cargo Jogg Olive M                                                               
4NN59KNBLA4XL	Stacy Adams Sweater/Pant Set Black 4XL                                                               
4NN59KNBLMNGL	Stacy Adams Sweater/Pant Set Black L                                                                 
4NN59KVMRMNGL	Stacy Adams Sweater/Pant Set Maroon L                                                                
4NN5THNGRK2XL	Nuvano Men's Pea Coat Gray XXL                                                                       
4NN8DMNCT0010	Samantha Satchel Chocolate                                                                           
4NN8GKBNVMNGL	Victory MN Heavy Fleece Lined  Navy L                                                                
4NN8GTNCHMNGL	Victory MN Fleece Sherpa Hoodi Charcoal L                                                            
4NN9TRNBLMNGL	Nuvano Men's 3/4 LENGTH FAUX W Black L                                                               
4NN9UANHEAMED	Champion WM 3 in 1 Systems Jac Heather Medium                                                        
4NNDIHANWWM2X	Plus Size 'Dulce' Tunic/Top Navy-White 2X                                                            
4NNDIKFPAA2XL	Majestic MM  NFL The Armor Hoo Patriots 2XL                                                          
4NNDIMFBWAMED	Majestic MN Long Sleeve T-shir Browns Medium                                                         
4NNDIMFKCALRG	Majestic MN Long Sleeve T-shir Chiefs Large                                                          
4NNM0GNBLK2XL	Victory MN Lamb Leather Classi Black XXL                                                             
4NNMZ3OLNALRG	Puma MN contrast track jkt Olive Night Large                                                         
4NNO52NWHBB40	Exquisite Form Longline Postur White 40 B                                                            
4NNQCQAZSP384	Dickies MN Sanded Duck Carpent Timber 38W 34L                                                        
4NNQCQGMSP384	Dickies MN Sanded Duck Carpent Moss 38W 34L                                                          
4NNQCXBNVP364	Dickies MN Loose Fit Double Kn Navy 36W 34L                                                          
4NNQXUNMLA1XL	24/7 Comfort Apparel Blue Magi Multi 1XL                                                             
4NNT6JNBHA3XL	Adidas Mens Essentials Fleece  Black-White 3XL                                                       
4NNVE9NBLONES	V. Fraas Ladies Twisted Loop 3 Black ONE SIZE                                                        
4NNW0VNBLAMED	JC WM Lined Leather Gloves Black Medium                                                              
4NNW1ENBLALRG	JC WM Wool Lined Leather Sheep Black Large                                                           
4NNW1ENBRAXLG	JC WM Wool Lined Leather Sheep Brown X Large                                                         
4NNW1KNBLASML	Vance Co. MN Lined Suede Glove Black Small                                                           
4NNZ2IFICMNGM	Majestic WM V Neck SS tee Lege Colts M                                                               
4NNZFRREDA2XL	Nuvano Men's  PJ set Red 2XL                                                                         
4NOADUREDK2XL	Timberland Men's Sherpa Lined  Red XXL                                                               
4NOAL0GYDMNGL	Adidas BIG Boys Coast to Coast Dark Grey L                                                           
4NOBVERPKMNGL	LA Pop Art WM Tee - Woof Paw P Pink L                                                                
4NOBWWFPKKD4X	Majestic MN BT Heart and Soul  Packers 4X                                                            
4NOC32RPK0010	Betsey Johnson Lux Fur Top Zip Pink                                                                  
4NOCL3NBLAMED	FAUX WOOL W/FAUX FUR COLLAR Black Medium                                                             
4NOGAFNRKA4XL	Berne MN Flex180 Washed Chore  Bark 4XL                                                              
4NOGAJNBLMNGM	Berne MN Flex180 Washed Chore  Black M                                                               
4NOI4MNBRONES	Lucky Brand Aden Small Tote Brown ONE SIZE                                                           
4NOI5CNPLONES	Lucky Brand  Nela Small Satche Praline ONE SIZE                                                      
4NOJ5LVVLBC48	MagicLift Full Figure Support  Violet 48 C                                                           
4NOKEAQBJMNGM	Old Pueblo Traders Chic Imitat Animal Foil M                                                         
4NOMFUBNVMNGL	CHRIS AND CAROL VELVET SWING D Navy L                                                                
4NOMGDHEGMNGM	HAPPY DAYS SUPERSOFT DRAWSTRIN Heather Grey M                                                        
4NOMGONFOMNGL	LE LIS VELVET BURNOUT KIMONO Navy Floral L                                                           
4NONS0NBLMNGM	ADORA HI LOW PONCHO LOOK KNIT  Black M                                                               
4NONSYNBLMNGM	ADORA HI LOW PONCHO LOOK WASHE Black M                                                               
4NOO4INBL0010	Ray Ban Black                                                                                        
4NOO5CYGO0010	Ray Ban Aviator Gold                                                                                 
4NOO5HNBR0010	Kenneth Cole Brown                                                                                   
4NOOZKHEGMNGM	RD STYLE OFF THE SHOULDER LACE Heather Grey M                                                        
4NOP1GGOLMNGM	ADORA MIXED MEDIA CAMO AND WAF Olive M                                                               
4NOQ6PNBLMNGM	Staccato Women's Rib Trim Supe Black M                                                               
4NOQU2NBLS100	AX Paris WM Plum Lace Long Sle Black 10                                                              
4NT523NBLA2XL	Excelled Rev. Leather Bomber Black 2 XL                                                              
4NT523NBLALRG	Excelled Rev. Leather Bomber Black Large                                                             
4NT523NCGAMED	Excelled Rev. Leather Bomber Cognac Medium                                                           
4NY797NRKAXLG	BerneApprlMNWshdHoodedDckJckt Bark X Large                                                           
4P9348BNVMNXA	Carhartt Duck Active/Therm Jkt Navy 2X50-52                                                          
4P9348NBRMNL0	Carhartt Duck Active Jac/Thermal Brown L42-44                                                        
4P9350BNVTLRG	Carhartt Duck Act Jac/Therm BT Navy Tall LRG                                                         
4P9409NRKP404	Berne Duck Bib Overall Bark 30-42 40W 34L                                                            
4PA692NBLBF36	Cortland FF Soft Cup Bra Black 36 DDD/F                                                              
4PG696REDBF46	Cortland Wire Bra Red 46 DDD/F                                                                       
4PR275NBLAMED	Duofold Mn ExpWeight AnklePant Black Medium                                                          
4PS148NWHM018	GMI Ms 3pc Duster Skirt Set White 18                                                                 
4PS149NWHW024	GMI Wm 3pc Duster Skirt Set White 24W                                                                
4QD567NBL0010	Rockland 2 Piece Solid Set Black                                                                     
4QD896BDNM010	Lee Ms Monroe StraightLeg Jean Denim 10                                                              
4QE845REDALRG	Winlar Ms Satin Robe Gown Set Red Large                                                              
4QE845REDALRG	Winlar Ms Satin Robe Gown Set Red Large                                                              
4QE845REDAMED	Winlar Ms Satin Robe Gown Set Red Medium                                                             
4QE845REDAMED	Winlar Ms Satin Robe Gown Set Red Medium                                                             
4QE845REDAMED	Winlar Ms Satin Robe Gown Set Red Medium                                                             
4QE845REDAMED	Winlar Ms Satin Robe Gown Set Red Medium                                                             
4QE845RRIALRG	Winlar Ms Satin Robe Gown Set Red Print Large                                                        
4QJ638NWHSL01	Champion Show Off Sports Bra White Large                                                             
4QZ447NKYM014	Nubiano Ms Peplum Brooch Suit Black-Royal 14                                                         
4QZ448ABYW016	Nubiano Wm Peplum Brooch Suit Black-Yellow 16W                                                       
4QZ448NEKW020	Nubiano Wm Peplum Brooch Suit White-Black 20W                                                        
4QZ448NWHW016	Nubiano Wm Peplum Brooch Suit White 16W                                                              
4RP189NBLSH2X	DLX Insulated Overall Black Short 2XL                                                                
4RP203NBLT3XL	DLX Insulated Overall-T/Big Black Tall 3XL                                                           
4RP203NBRT3XL	DLX Insulated Overall-T/Big Brown Tall 3XL                                                           
4RQ383NBLTLRG	Weathered Shirt Jac B&T Black Tall LRG                                                               
4RQ384NBRA2XL	Weathered Shirt Jac Brown 2XL                                                                        
4ST934NBL0010	Men's Bifold Wallet Black                                                                            
4SY151NWHBD4F	Front Close Leisure Bra White 44 DD/F                                                                
4SY397NBL0010	Tank Messenger Bag Black                                                                             
4SZ866VBGBX56	Full Figure Support Bra Burgundy 56 DD                                                               
4TC332NBL0010	The Sak SANIBEL BUCKET Black                                                                         
4F0859NTP0010	StrchPinstrip ReclinerSlipcvr-Taupe                                                                  
4F86410000010	Permafresh Basic Queen Protector Set                                                                 
4F9398NCT0010	Quilted Suede Chair Pet Cover - Chocolate                                                            
4F9838NIV0010	Eclipse Canova 42x84" Panel Ivory                                                                    
4F9838NIV0010	Eclipse Canova 42x84" Panel Ivory                                                                    
4J46080000010	Ulti-Mate Bath and Shower Pole Caddy                                                                 
4N3018NIV0010	Halley 56x63 Window In A Bag Ivory                                                                   
4N3018RMY0010	McLeland Halley 56x63 Window In A Bag Merlot                                                         
4N3018RMY0010	McLeland Halley 56x63 Window In A Bag Merlot                                                         
4N3018RMY0010	McLeland Halley 56x63 Window In A Bag Merlot                                                         
4N3018RMY0010	McLeland Halley 56x63 Window In A Bag Merlot                                                         
4N3018RMY0010	McLeland Halley 56x63 Window In A Bag Merlot                                                         
4N3018RMY0010	McLeland Halley 56x63 Window In A Bag Merlot                                                         
4N3019GSG0010	McLeland Halley 56x84 Window In A Bag Sage                                                           
4N3019GSG0010	McLeland Halley 56x84 Window In A Bag Sage                                                           
4N3019NIV0010	McLeland Halley 56x84 Window In A Bag Ivory                                                          
4N3019RMA0010	McLeland Halley 56x84 Window In A Bag Mauve                                                          
4NB7DDNCM0010	MLD Fade Resist Bath Sheet Cream                                                                     
4NBCWDARC0010	alcove NoSkid FastDryRug 20x34 Arctic Blue                                                           
4NBJ11ORG0010	Realtree Comforter Set Orange                                                                        
4NBL05GNG0010	SFUltimateWtrprfSuede Rclnr/Wn Loden Green                                                           
4NBL06GNG0010	SFUltimate Waterproof Suede Lo Loden Green                                                           
4NBL07GNG0010	SFUltimate Waterproof Suede So Loden Green                                                           
4NCMK0NWHDQEN	McLeland Firm Queen 2pk Pillows White Queen                                                          
4NCMK1NWHDQEN	McLeland X-Firm Queen 2pk Pillo White Queen                                                          
4NDLZANCA0010	Wellrest Warming Neck Pillow Camel                                                                   
4NDQ9CNMLDQEN	Utopia Six Piece Cotton Comfor Multi Queen                                                           
4NFRYINBH0010	2 Piece Zebra Bath Rug Set Black-White                                                               
4NFYDWDLVDTWN	ALC REVERSIBLE COVE Purple/Bright Purple Twin                                                        
4NG4250000010	Sensorpedic Classic Pillows-2pack                                                                    
4NGNUBNSM0010	Eclipse  Nikki Grommet Blacko Smoke                                                                  
4NGNUBNSM0010	Eclipse  Nikki Grommet Blacko Smoke                                                                  
4NGRYBNEX0010	EclipseFresno 52x63 Blackout Panel Espresso                                                          
4NGRYBNEX0010	EclipseFresno 52x63 Blackout Panel Espresso                                                          
4NGRYBNEX0010	EclipseFresno 52x63 Blackout Panel Espresso                                                          
4NGRYBNEX0010	EclipseFresno 52x63 Blackout Panel Espresso                                                          
4NHUMCRPKDFUL	alc 8Pc.BIAB WatercolorStripe- Pink Full                                                             
4NIC6DNMLDKNG	Alcove BLACK BEAR BIAB - K Multi King                                                                
4NIFR0ROS0010	MLD Sadie 5Pc Window Rose                                                                            
4NIFR9REDDQEN	ALC Astoria 30pc Comf - Q Red Queen                                                                  
4NIFR9REDDQEN	ALC Astoria 30pc Comf - Q Red Queen                                                                  
4NIFRYROSDKNG	MLD Sadie 8pc Comf - K Rose King                                                                     
4NINJY0000010	My Pillow Queen Firm                                                                                 
4NINJY0000010	My Pillow Queen Firm                                                                                 
4NINJY0000010	My Pillow Queen Firm                                                                                 
4NINO9VBGDQEN	1800 Series Premium Ultra Soft Burgundy Queen                                                        
4NINOCGSGDCKG	1800 Series Premium Ultra Plus Sage Cal Kng                                                          
4NINRNNIVDCKG	1800 Series Premium Ultra Plus Ivory Cal Kng                                                         
4NJKAWNIV0010	alc Clarke Tier 56x14 Ivory                                                                          
4NJKAWNIV0010	alc Clarke Tier 56x14 Ivory                                                                          
4NJKAWNIV0010	alc Clarke Tier 56x14 Ivory                                                                          
4NJKAWNIV0010	alc Clarke Tier 56x14 Ivory                                                                          
4NJKAWNIV0010	alc Clarke Tier 56x14 Ivory                                                                          
4NJKAWNIV0010	alc Clarke Tier 56x14 Ivory                                                                          
4NJKAWNIV0010	alc Clarke Tier 56x14 Ivory                                                                          
4NJKAWNIV0010	alc Clarke Tier 56x14 Ivory                                                                          
4NJKAWNIV0010	alc Clarke Tier 56x14 Ivory                                                                          
4NJKAWNMC0010	alc Clarke Tier 56x14 Mocha                                                                          
4NJKAWNMC0010	alc Clarke Tier 56x14 Mocha                                                                          
4NJKAWNMC0010	alc Clarke Tier 56x14 Mocha                                                                          
4NJKAWNMC0010	alc Clarke Tier 56x14 Mocha                                                                          
4NJKAWNMC0010	alc Clarke Tier 56x14 Mocha                                                                          
4NJKAWRPP0010	alc Clarke Tier 56x14 Paprika                                                                        
4NJKAWYEL0010	alc Clarke Tier 56x14 Yellow                                                                         
4NJKAYRPP0010	alc Clarke Tier 56x36 Paprika                                                                        
4NJKAYRPP0010	alc Clarke Tier 56x36 Paprika                                                                        
4NJKAZBNV0010	alc Clarke Tier 56x24 Navy                                                                           
4NJKAZNIV0010	alc Clarke Tier 56x24 Ivory                                                                          
4NJKAZNIV0010	alc Clarke Tier 56x24 Ivory                                                                          
4NJKAZNIV0010	alc Clarke Tier 56x24 Ivory                                                                          
4NJKAZNIV0010	alc Clarke Tier 56x24 Ivory                                                                          
4NJKAZYEL0010	alc Clarke Tier 56x24 Yellow                                                                         
4NK1AYGTLFLQN	Madison Park Tara 6 Piece Quil Teal Full/Queen                                                       
4NK2K4NRU0010	Bath Bliss 3-Tier Corner Rack Rust                                                                   
4NK31DNBL0010	BENTLEY SUEDE BCKG - PLW Black                                                                       
4NK3N8NWHFLQN	TRE 300T Down Comf - F/Q White Full/Queen                                                            
4NK6NEUAL0010	NCAA Home Field Advantage Tape U of AL                                                               
4NK79GNBR0010	Faux Linen Panel 84in Brown                                                                          
4NK79GNBR0010	Faux Linen Panel 84in Brown                                                                          
4NK8UEDCTDKNG	alc 3pc Solid Color Quilt King Dark Chocolate                                                        
4NK8UEDSGDKNG	alc 3pc Solid Color Quilt King  Dusty Green                                                          
4NKHVULTG0010	Lush Decor Darcie Window Curta Light Gray                                                            
4NKQTJNWHDQEN	Restful Nights Comfort Edge Pi White Queen                                                           
4NKQTLNWHDKNG	Restful Nights All Natural Dow White King                                                            
4NKT41GSG0010	McLeland Sutton Panel 52" x 63" - Brown Sage                                                         
4NKT41GSG0010	McLeland Sutton Panel 52" x 63" - Brown Sage                                                         
4NKT41NTN0010	McLeland Sutton Panel 52" x 63" - Brown Tan                                                          
4NKT41NTN0010	McLeland Sutton Panel 52" x 63" - Brown Tan                                                          
4NKT4LNCH0010	Emily Panel 59x108 Charcoal                                                                          
4NKT4LNCH0010	Emily Panel 59x108 Charcoal                                                                          
4NKT4LNCH0010	Emily Panel 59x108 Charcoal                                                                          
4NKT4LNWH0010	Emily Panel 59x108 White                                                                             
4NKT4MNTP0010	Regan-PT 54 95 Panel Taupe                                                                           
4NKT7VGTLDKNG	MiZone Camille 4 PC Duvet Cove Teal King                                                             
4NKUAMBLU0010	ELNORA LOVESEAT PROTECTOR Blue                                                                       
4NKUAWNCT0010	REVERSE WATERPROOF SOFA Chocolate                                                                    
4NKUAWVBG0010	REVERSE WATERPROOF SOFA Burgundy                                                                     
4NKUBHVBG0010	REVERSE WATERPROOF LOVESEAT Burgundy                                                                 
4NKUBMNML0010	PAISLEY PATCH LOVESEAT PROTECT Multi                                                                 
4NKUPINEX0010	Zenna Home Bathroom Spacesaver Espresso                                                              
4NKUPJMCH0010	Zenna Home NeverRust Aluminum  Chrome                                                                
4NL1I2NTN0010	Taylor - Lined Grommet Panel - Tan                                                                   
4NLABBZMGDFUL	alc Solid Color Sheet Set - Fl Montana Grape Full                                                    
4NLABSLSMDTWN	alc Solid Color Rev Comf - Tw Blossom Twin                                                           
4NLFIEUNBDQEN	alc Venice 20Pc Set - Queen Neutral/Blue Queen                                                       
4NLIN3NGR0010	Madison Park Westmont Shower C Gray                                                                  
4NLS8GPC30010	Mossy Oak Break-Up Infinity Fu Camouflage                                                            
4NLTA4NBZDQEN	Portsmouth Home Delaney 8 Piec Bronze Queen                                                          
4NLTUCWNBDFUL	DAKOTA 11PC BED IN A BA Navy Blue Full                                                               
4NMA9XNTP0010	METRO 54" X 16" STRAIGHT VALAN Taupe                                                                 
4NMA9XNTP0010	METRO 54" X 16" STRAIGHT VALAN Taupe                                                                 
4NMBAJNCT0010	BLACKSTONE 54" X 84" WINDOW PA Chocolate                                                             
4NMBAJNCT0010	BLACKSTONE 54" X 84" WINDOW PA Chocolate                                                             
4NMBAJNCT0010	BLACKSTONE 54" X 84" WINDOW PA Chocolate                                                             
4NMBDONWH0010	Valerie 52x38 1pc Kitchen Swag White                                                                 
4NMCTQNGRDKNG	CIRCLE RUFFLE 30PC COMFORTER S Gray King                                                             
4NMCTRNGRDCKG	CIRCLE RUFFLE 30PC COMFORTER S Gray Cal Kng                                                          
4NMCUNNGRDQEN	CIRCLE RUFFLE 30PC COMFORTER S Gray Queen                                                            
4NMERONWH0010	1-2-3  Shade Vinyl Room Darken White                                                                 
4NMJUCBIKDQEN	Chic Home Zoe 5 Piece Hexagon  Brick Queen                                                           
4NMKTOGMTDQEN	JANE SEYMOUR COLLECTION: EMPRE Mint Queen                                                            
4NMQE4GRN0010	Portsmouth Home 100% Cotton Re Green                                                                 
4NMVHUBMO0010	Alcove Everyday Bath Rug 2 PC  Blue Monday                                                           
4NN668NWH0010	StainlessSteel Dual Bath Caddy White                                                                 
4NNFICVPMFLQN	ALC Super Loft Blanket - Full/ Plum Full/Queen                                                       
4NNFIDRCB0010	MLD 3-in-1 throw Cranberry                                                                           
4NNFIKGAG0010	alcove 16pc Egyptian Towel Set Aqua Green                                                            
4NNFIKNBR0010	alcove 16pc Egyptian Towel Set Brown                                                                 
4NNL88VPRDFUL	ALCOVE HARPER 8PC COMFORTER SE Purple Full                                                           
4NNOL2YDGDTWN	alc Metro 8Pc Set - Twin Yellow-Dark Gray Twin                                                       
4NNOLDBLUDQEN	alc Cathleen 8Pc Set -Queen Blue Queen                                                               
4NNRD1NGRFLQN	Lush Decor Printed Cable Knit  Gray Full/Queen                                                       
4NNSLGNNTGLSM	alcove Embossed Super Soft thr Natural S/M                                                           
4NNSLGNNTGLSM	alcove Embossed Super Soft thr Natural S/M                                                           
4NNSLGREDGLSM	alcove Embossed Super Soft thr Red S/M                                                               
4NNSLGVPRGLSM	alcove Embossed Super Soft thr Purple S/M                                                            
4NNSLLPLEWMLX	Alcove Fur Trim Robe & Slipper Leopard L/XL                                                          
4NNSLLPLEWMLX	Alcove Fur Trim Robe & Slipper Leopard L/XL                                                          
4NNSLQNGRGLSM	Alcove Fur Trim Robe & Slipper Gray S/M                                                              
4NNSLQNGRGLSM	Alcove Fur Trim Robe & Slipper Gray S/M                                                              
4NNSLQNGRGLSM	Alcove Fur Trim Robe & Slipper Gray S/M                                                              
4NNSLQPLEGLSM	Alcove Fur Trim Robe & Slipper Leopard S/M                                                           
4NNT4V0000010	alc Flying eagle fun micro fur                                                                       
4NNT5GNH70010	Waterproof Furniture slip cove Chocolate-Sage                                                        
4NNT9BPSF0010	Alcove Heated Microplush Throw Snowflake                                                             
4NNXCONTPDTWN	ALC Microflce Sheet St Snow Fl Taupe Twin                                                            
4NNXCONTPDTWN	ALC Microflce Sheet St Snow Fl Taupe Twin                                                            
4NNYNPFPN0010	NFL Bed Rest Panthers                                                                                
4NNYNPFPN0010	NFL Bed Rest Panthers                                                                                
4NNYOZGYDONES	Alcove Throw and Memory Foam T Dark Grey ONE SIZE                                                    
4NNYOZPS5ONES	Alcove Throw and Memory Foam Snow Leopard ONE SIZE                                                   
4NOC38NCT0010	Alcove Microfiber Loveseat Pet Chocolate                                                             
4NOC39NTP0010	Alcove Microfiber Recliner Pet Taupe                                                                 
4NOCW9RPK0010	LARRISA BATH RUG Pink                                                                                
4NOCZOGSGDQEN	Microfiber Bed Tite Sheet Set Sage Queen                                                             
4NOCZOVBGDQEN	Microfiber Bed Tite Sheet Set Burgundy Queen                                                         
4NOEGNBLU8452	Lush Decor Julia Stripe Room D Blue 84 X 52                                                          
4NOMPHBWD0010	Hawthorne Chenille Bedspread - Wedgewood                                                             
4NONQQ0000010	MyPillow King Mattress Topper                                                                        
4NP365RCM0010	FauxSuede 22" Dec PillowSet-Crimson                                                                  
4NX450GAQ0010	Mohawk RaisedStriped 3pBathRug Aqua                                                                  
4NX450GTL0010	Mohawk RaisedStriped 3pBathRug Teal                                                                  
4PG817BSP0010	Superior LongStaplCotton 2pc Bath Sheet Sapphire                                                     
4PG938NGR0010	Stretch Metro 2pc LS Slipcover Gray                                                                  
4PJ4180000010	IsoCool Queen Mattress pad                                                                           
4PQ605BUC0010	TerraEmbroidered 108x84PanelPr Blue-Chocolate                                                        
4PR641VBE0010	Scroll 5pc Bath Rug Set Berry                                                                        
4PU598NEW0010	McLeland Design ToiletLidCover Seal Brown                                                            
4PU598VPM0010	McLeland Design ToiletLidCover Plum                                                                  
4PX7520000010	Sensorpedic 3" Deluxe QN Memory Foam Topper                                                          
4PX7520000010	Sensorpedic 3" Deluxe QN Memory Foam Topper                                                          
4PX7520000010	Sensorpedic 3" Deluxe QN Memory Foam Topper                                                          
4PX7530000010	Sensorpedic 3" Deluxe FL Memory Foam Topper                                                          
4PX7550000010	Sensorpedic 3" Deluxe KG Memory Foam Topper                                                          
4QC008NCP0010	MLD Venetian 84x16 Valance Champagne                                                                 
4QC616FRE0010	NFL Microplush Throw Redskins                                                                        
4QC616FSA0010	NFL Microplush Throw Saints                                                                          
4QC617FCB0010	NFL Comfy Throw Cowboys                                                                              
4QH0800000010	My Pillow Queen Standard                                                                             
4QH0800000010	My Pillow Queen Standard                                                                             
4QJ586NBK0010	MLD Regan 54x18Window Valance Brick                                                                  
4QJ588BNV0010	MLD Regan 54"x63" Window Panel Navy                                                                  
4QJ588BNV0010	MLD Regan 54"x63" Window Panel Navy                                                                  
4QJ588NCT0010	MLD Regan 54"x63" Window Panel Chocolate                                                             
4QJ588NCT0010	MLD Regan 54"x63" Window Panel Chocolate                                                             
4QJ588NCT0010	MLD Regan 54"x63" Window Panel Chocolate                                                             
4QT115BLU0010	FolkloreQN3pcJaqdBedspreadSet Blue                                                                   
4QT115BLU0010	FolkloreQN3pcJaqdBedspreadSet Blue                                                                   
4QU5350000010	MLD 4" TW Gel Mem Foam Topper                                                                        
4QV287NWF0010	Patricia 84x52 Grommet Panel Brown-Coffee                                                            
4QV287NWF0010	Patricia 84x52 Grommet Panel Brown-Coffee                                                            
4QW4440000010	MLD Lansing 5pcWindow Set                                                                            
4QW4440000010	MLD Lansing 5pcWindow Set                                                                            
4RG458NBR0010	McLeland Sutton 84" Blackout Brown                                                                   
4RL6390000010	UptownStripe2pcChenlBdspSet-TW                                                                       
4RM029BFR0010	Alcove SolidMicrofFLSheetSet French Blue                                                             
4RM973BLU0010	AlcoveFastDry10pcBathTowelSet Arctic Blue                                                            
4RM973GRN0010	AlcoveFastDry10pcBathTowelSet Garden Green                                                           
4RM973NC40010	AlcoveFastDry10pcBathTowelSet Coffee                                                                 
4RM973NVA0010	AlcoveFastDry10pcBathTowelSet Vanilla Ice                                                            
4RT265YCA0010	Alcove SpringPrintSheet Set-FL Yellow Camo - DNU                                                     
4RW195CSB0010	MLD Fade Resist Bath Rug 20x34 Spectrum Blue                                                         
4RW195CSB0010	MLD Fade Resist Bath Rug 20x34 Spectrum Blue                                                         
4RW993RGN0010	alcove Microplush ElectTWBlnkt Garnet                                                                
4RW994RGN0010	alcove Elec Microplush FLBlnkt Garnet                                                                
4RX001WDB0010	alcove Elec Microplush QNBlnkt Denim Blue                                                            
4RX001WDB0010	alcove Elec Microplush QNBlnkt Denim Blue                                                            
4RY391GSG0010	alcove 20x34 Everyday Bath Rug Sage                                                                  
4RY396NR60010	alcove 20x24 Everyday Contour Rug Rich Black                                                         
4RY440BMO0010	alcove 2pc Everyday Tank Set Blue Monday                                                             
4SA3980000010	Alcove Briar 8pc Bed Set-QN                                                                          
4SB779NWH0010	1000 Egyptian DA Pillow-DA/P-3 White                                                                 
4SB956NSA0010	MADLucerne Loveseat Slipcover Sand                                                                   
4SF440NWH0010	Rollaway Cot Topper White                                                                            
4SF6190000010	alcove Palazzo 20pc Bed Set QN                                                                       
4SF6280000010	Cambridge 20 Pc. Bedset - Qn                                                                         
4SF6380000010	alcove Geox 20pc Bed Set QN                                                                          
4SH7360000010	Wild Girl Bed Set -Full                                                                              
4SM480BLU0010	Genevieve McLeland 8pc . Queen Blue                                                                  
4TA5480000010	4" Alcove Visco Topper                                                                               
4TA5530000010	4" McLeland Gel Topper King                                                                          
4TF156RED0010	Estate Garden Window Curtain Red                                                                     
4TF156RED0010	Estate Garden Window Curtain Red                                                                     
4TF156RED0010	Estate Garden Window Curtain Red                                                                     
4TF156RED0010	Estate Garden Window Curtain Red                                                                     
4TK840NSB0010	Non-Skid Microfiber Pet Cover  Sable                                                                 
4TK841NGR0010	Non-Skid Microfiber Pet Cover  Gray                                                                  
4TK841NSB0010	Non-Skid Microfiber Pet Cover  Sable                                                                 
4TK843NCT0010	Simple Stretch Twill Loveseat Chocolate                                                              
4TK844NCT0010	Simple Stretch Twill Sofa Chocolate                                                                  
4TK845NCT0010	Non-Skid Microfiber Pet Cover  Chocolate                                                             
4TL054VAB0010	Ombre Waterfall Valance 46x42 Aubergine - dnu                                                        
4TL054VAB0010	Ombre Waterfall Valance 46x42 Aubergine - dnu                                                        
4TL054VAB0010	Ombre Waterfall Valance 46x42 Aubergine - dnu                                                        
4TL054VAB0010	Ombre Waterfall Valance 46x42 Aubergine - dnu                                                        
4TL054VAB0010	Ombre Waterfall Valance 46x42 Aubergine - dnu                                                        
4TL054VAB0010	Ombre Waterfall Valance 46x42 Aubergine - dnu                                                        
4TL106RED0010	Gala Red                                                                                             
4TL658NWHDKNG	EZDreams Matt Pad Wk-Away Kng White King                                                             
4TN173GTLDTWN	Floral Etched Fleece Blanket w Teal Twin                                                             
4UB558BNV0010	Alcove Rod Pocket Panel Pair 6 Navy                                                                  
4UB561NCA0010	Alcove 5Pc Rod Pocket 63" Camel                                                                      
4UK938GSG0010	ALC Fleece Heated Blanket - Ki Sage                                                                  
4UK939NTP0010	ALC Fleece Heated Blanket - Fu Taupe                                                                 
4UK940NBR0010	ALC Fleece Heated Blanket - Qu Brown                                                                 
4UM951NGR0010	Alc DownAlternative Blnkt F/Q Gray                                                                   
4UM955GSF0010	Alc DownAlternative Blnkt KG Seafoam                                                                 
4UM957BNV0010	MLD - 3M Peak Performance Shee Navy                                                                  
4UM965BWD0010	Alc OS SatinTrimFleec Blnkt KG Wedgewood                                                             
4UR665VPMDQEN	alc Forest Comf+FS- Qn Plum Queen                                                                    
4US003ABFDKNG	Alc 20Pc NALA - King Blue-Fuchsia-Silver King                                                        
4US008NTWDKNG	Alc 20Pc HEADLINER - Kg Black-Teal-White King                                                        
4US008NTWDKNG	Alc 20Pc HEADLINER - Kg Black-Teal-White King                                                        
4US049NBL0010	alc  Bandana Blk Dec Pillow Black                                                                    
4US049NBL0010	alc  Bandana Blk Dec Pillow Black                                                                    
4US260VPM0010	MLD Parisian Bath Window Set Plum                                                                    
4J84750000010	MTX 12" 2-Way Speaker                                                                                
4J84750000010	MTX 12" 2-Way Speaker                                                                                
4NB2Z40000010	Nest Learning Thermostat                                                                             
4NBEZJ0000010	Samsung 5.1 CH Blu-ray 3D Smar                                                                       
4NBEZJ0000010	Samsung 5.1 CH Blu-ray 3D Smar                                                                       
4NDLTC0000010	HP OfficeJet 4650 All in One Printer                                                                 
4NDLTC0000010	HP OfficeJet 4650 All in One Printer                                                                 
4NDP4S0000010	HP OfficeJet 3830 All in One P                                                                       
4NDP4S0000010	HP OfficeJet 3830 All in One P                                                                       
4NJBKG0000010	Royal 6 Sheet Shredder -Strip                                                                        
4NJUCN0000010	HP Officejet Pro 8710 Inkjet M                                                                       
4NKKZM0000010	Microsoft Office 365 Personal                                                                        
4NKSU60000010	Hal Leonard PLAY UKULELE TODAY                                                                       
4NKUAF0000010	Brother MFC-J485DW Inkjet Mult                                                                       
4NKUAF0000010	Brother MFC-J485DW Inkjet Mult                                                                       
4NKUAF0000010	Brother MFC-J485DW Inkjet Mult                                                                       
4NKUAF0000010	Brother MFC-J485DW Inkjet Mult                                                                       
4NKUAF0000010	Brother MFC-J485DW Inkjet Mult                                                                       
4NKUAF0000010	Brother MFC-J485DW Inkjet Mult                                                                       
4NKUAF0000010	Brother MFC-J485DW Inkjet Mult                                                                       
4NKUAF0000010	Brother MFC-J485DW Inkjet Mult                                                                       
4NKUM60000010	IPAD PRO SMART KEYBOARD                                                                              
4NKW1Y0000010	HP OfficeJet Pro 6968 All in O                                                                       
4NL6Y7NBL0010	Port. DVD 9" TFT, Remote w/USB Black                                                                 
4NL7B50000010	Port Dual Screen 7"DVD, Remote                                                                       
4NL7B6BLU0010	Port. DVD 7" TFT, Remote w/ Du Blue                                                                  
4NM5HYNWH0010	Google Home Voice Activated Sp White                                                                 
4NMDDD0000010	Beats Solo3 Wireless On-Ear He                                                                       
4NMDDF0000010	BeatsX Earphones - Black                                                                             
4NMYYN0000010	Amazon Echo - White                                                                                  
4NN1ND0000010	Amazon Echo Dot - White                                                                              
4NN2G0NBL0010	Dell 23" 1920x1080 LED Monitor Black                                                                 
4NN43A0000010	Avgo 24" HD 720P LED TV / DVD                                                                        
4NN43A0000010	Avgo 24" HD 720P LED TV / DVD                                                                        
4NN4RP0000010	Avgo 12 Sheet Cross Cut Shredd                                                                       
4NN4RP0000010	Avgo 12 Sheet Cross Cut Shredd                                                                       
4NN51Y0000010	GuruGear 1.8m Gold Plated HDMI                                                                       
4NN5LR0000010	Karaoke - Pop Party Pack 7                                                                           
4NN5S20000010	Jensen JTA-325 3-Speed Stereo                                                                        
4NN6B80000010	GuruGear Foldable Wireless Key                                                                       
4NN6CE0000010	GuruGear Wired Mouse                                                                                 
4NN6CE0000010	GuruGear Wired Mouse                                                                                 
4NN6CE0000010	GuruGear Wired Mouse                                                                                 
4NN6CM0000010	GuruGear 2.4G Wifi Control Fol                                                                       
4NN6CM0000010	GuruGear 2.4G Wifi Control Fol                                                                       
4NNB7U0000010	beFree Sound 12 Inch Bluetooth                                                                       
4NNDU5NBL0010	VIZIO D-series 55" Class D55-E0 (54.6 Black)                                                         
4NNSIW0000010	LG Audio OJ98 Hi-Fi Entertainm                                                                       
4NOJQ40000010	TERK Cord Cutter Kit                                                                                 
4NQ2890000010	AVGO 3CD/Turntable/Hdph                                                                              
4PF9690000010	Jensen CD/Record/Turn/Cass Str                                                                       
4RB5320000010	Audio Technica USB Turntable                                                                         
4RS5650000010	Jensen BT Under Cabinet System                                                                       
4RU5000000010	Spectrum Keyboard Stand                                                                              
4SG0720000010	Kicker BT Wireless Headphone                                                                         
4UK0030000010	HP 20" LED Backlit Black Monit                                                                       
4UN688NBL0010	Polaroid Zip Mobile Instant Pr Black                                                                 
4UR7090000010	LG Bluray Player                                                                                     
4H7825NBRS100	Laredo Mns Wide  Western Boot-Brown-10                                                               
4NBDGUNTNS080	Ariat WM FATBABY HERITAGE Tan 8                                                                      
4NBMBTNWES090	Over The Chill WP Insulated Winter White 9                                                           
4NBNT5NGRS090	Itasca WM Lakeland Gray Gray 9                                                                       
4NBUA2NBLS090	Sperry MN Avenue Duck Boot Black 9                                                                   
4NBUA2NTNS085	Sperry MN Avenue Duck Boot Tan 8.5                                                                   
4NBUASNKHS115	Sperry MN Bahama 2-Eye Boat Khaki 11.5                                                               
4NC0J6BNVS100	Easy Street Women's Holly Comf Navy 10                                                               
4NC0YJNBLS085	Easy Street Origin Women's Com Black 8.5                                                             
4NC6K2NDBS085	Dr. Scholl's WMNS Frankie flat Dark Brown 8.5                                                        
4NCDCYBNVS100	STACY ADAMS MN GALA Navy 10                                                                          
4NCDLDNBHS095	SKECHERS WN ME TIME Black-White 9.5                                                                  
4NCDLDNBHS100	SKECHERS WN ME TIME Black-White 10                                                                   
4NCJ3QNWWS060	Puma Jr Smash Fun L White-White 6                                                                    
4NCJ40BLKS065	Puma Jr Smash Fun L Black-Black 6.5                                                                  
4NCLCRNNTS090	Muk Luks Women's Jamie Boot Natural 9                                                                
4NCZ94NBLS090	Easy Street Women's Fabulous P Black 9                                                               
4NDATANRUS060	Dingo WM Cassidy Rust 6                                                                              
4NDHK6N11S115	Lugz Empire HI Wr MN BOOT Black-Charcoal 11.5                                                        
4NF7QCNBRS080	Minnetonka WM Pile Lined Hards Brown 8                                                               
4NF7QONBRS100	Minnetonka Women's 5 Layer Fri Brown 10                                                              
4NF7QONLWS100	Minnetonka Women's 5 Layer Fri Light Brown 10                                                        
4NF7QPNBLS080	Minnetonka Women's 3 Layer Fri Black 8                                                               
4NF7QPNBLS090	Minnetonka Women's 3 Layer Fri Black 9                                                               
4NF7QPNBLS100	Minnetonka Women's 3 Layer Fri Black 10                                                              
4NG2MDNBLS100	Stacy Adams Men's Waltham Black 10                                                                   
4NG2TWNBRS120	New Balance WM Trail Walking 6 Brown 12                                                              
4NG4DUNBLS085	New Balance WM 626v2 Work Shoe Black 8.5                                                             
4NHB4FNCHS105	Skechers MN Nuovo Cutback Charcoal 10.5                                                              
4NHS64NBRS105	Georgia Boot Men's Homeland 10 Brown 10.5                                                            
4NHS7ONTNS070	Georgia Boot Men's Farm & Ranc Tan 7                                                                 
4NHS8KNBRS105	Georgia Boot Men's Farm  Ranch Brown 10.5                                                            
4NI300NBRS090	Laredo MN 12" Snake Prnt Boot Brown 9                                                                
4NI4FQNBRS130	Minnetonka Men's Pile Lined Ha Brown 13                                                              
4NI950NBLS080	Georgia MN Logger 8" Boot Black 8                                                                    
4NI968NBRS090	Georgia Giant MN 8" Work Boot-Wide Brown 9                                                           
4NIKF9NBRS130	Rocky Men's Ride LT Western Bo Brown 13                                                              
4NIKGLNBRS095	Rocky Men's Elements Shale WP  Brown 9.5                                                             
4NIKGLNBRS095	Rocky Men's Elements Shale WP  Brown 9.5                                                             
4NIKHQNBRS070	Rocky Women's Aztec Lace-up Wo Brown 7                                                               
4NJBB9NBLS080	REPORT WMN EVERTON Boot Black 8                                                                      
4NJCMINCTS100	BEARPAW WM EMMA 8" BOOT Chocolate 10                                                                 
4NJI5LNBLS140	Slipperooz by Deer Stags MN No Black 14                                                              
4NJPAFNBLS095	Merrell Men's Moab Polar Boot Black 9.5                                                              
4NJWYRNBLS120	Wolverine MN Merlin Waterproof Black 12                                                              
4NJXD7XDBS070	Cat Footwear MN Diagnostic HI  DARK BEIGE 7                                                          
4NJZXHREDS080	Minnetonka Women's Plaid Cally Red 8                                                                 
4NK29QNBLS075	Adidas Neo Mens Cloudfoam Adva Black 7.5                                                             
4NK3CANBLSAMD	Muk Luks WM Pattern Knit Clog Black M (7-8)                                                          
4NK3YCBDRS060	MUK LUKS Women's Shawna Boots Dark Blue 6                                                            
4NK3YYNRNS080	MUK LUKS Women's Bianca Boots Medium Brown 8                                                         
4NK5M3NBLS085	NB MN CUSH+ 365v1 Black 8.5                                                                          
4NK6PJANPS090	SK WM GO STEP LITE Navy-Pink 9                                                                       
4NK6QJBNVS070	Timberland WM Teddy Fleece WP  Navy 7                                                                
4NK7F4VWIS070	Easy Street Sport "Laurel" Ath Wine 7                                                                
4NK7GPNK2S100	Easy Street Origin Comfort Clo Black Smooth 10                                                       
4NK7GPNTNS100	Easy Street Origin Comfort Clo Tan 10                                                                
4NK7J0NBLS100	JCollect WM Viv Faux Leather F Black 10                                                              
4NK7J7NGRS080	JCollect WM Gia Tasseled Wedge Gray 8                                                                
4NK7JWREDS075	JCollect WM Cairo Lace-up Ankl Red 7.5                                                               
4NK7KDNBLS075	JCollect WM Olina T-strap  Mar Black 7.5                                                             
4NK7M0MBKS080	Easy Street Dawnta Bootie - Na Matte Black 8                                                         
4NK8ARSGYS095	Life Stride WM X-MUST WC Boot Storm Gray 9.5                                                         
4NKH0NNTPS075	Journee Collection Women's Sun Taupe 7.5                                                             
4NKHYONGRS080	Journee Collection Womens Rebe Gray 8                                                                
4NKHYPNBLS090	Journee Collection Womens Rebe Black 9                                                               
4NKHYPNBLS110	Journee Collection Womens Rebe Black 11                                                              
4NKHYPNBRS080	Journee Collection Womens Rebe Brown 8                                                               
4NKHYPNBRS085	Journee Collection Womens Rebe Brown 8.5                                                             
4NKHYPNGRS090	Journee Collection Womens Rebe Gray 9                                                                
4NKHYQNBLS095	Journee Collection Women's Lat Black 9.5                                                             
4NKHYQNDBS070	Journee Collection Women's Lat Dark Brown 7                                                          
4NKHYQNDBS080	Journee Collection Women's Lat Dark Brown 8                                                          
4NKHYRNBLS100	Journee Collection Women's Lat Black 10                                                              
4NKHYRNBLS100	Journee Collection Women's Lat Black 10                                                              
4NKHYVNBLS075	Journee Collection Women's Ang Black 7.5                                                             
4NKHYVNBLS075	Journee Collection Women's Ang Black 7.5                                                             
4NKHYVNBLS095	Journee Collection Women's Ang Black 9.5                                                             
4NKHYVNGRS095	Journee Collection Women's Ang Gray 9.5                                                              
4NKHYVNTNS075	Journee Collection Women's Ang Tan 7.5                                                               
4NKHYWNBLS075	Journee Collection Women's Ang Black 7.5                                                             
4NKHYWNBLS100	Journee Collection Women's Ang Black 10                                                              
4NKHYWNTNS070	Journee Collection Women's Ang Tan 7                                                                 
4NKHZFNBLS085	Journee Collection Women's Mag Black 8.5                                                             
4NKHZINCNS075	Journee Collection Women's Fri Chestnut 7.5                                                          
4NKVDPNDBS090	McRae MN 11" Waterproof Pull-O Dark Brown 9                                                          
4NL67RNWHS065	Reebok WM Princess Fitness White 6.5                                                                 
4NL71KNCHS100	PUMA MN TAZON 6 FRACTURE FM Charcoal 10                                                              
4NLBE2NWTS110	Timberland MN Field Boot F/L W Wheat 11                                                              
4NLCHYNTPS070	SKX WMNS ReggaeFest - DORY Fis Taupe 7                                                               
4NLIP0NBLS100	Journee WM Bristl Zippered Hig Black 10                                                              
4NLIPTNBLS010	Journee Kids Anza Round Toe Fr Black 1                                                               
4NLIPUNCNS030	Journee Kids Luzie Round Toe F Chestnut 3                                                            
4NLJUVNB3S110	SK Boys Skech-Train Gore & Str Black-Red 11                                                          
4NLOUVNBLGLSM	MUK LUKS Women's Stretch Glove Black S/M                                                             
4NLSG8NBLS110	J. Collection WM Wide Calf Kne Black 11                                                              
4NLSHBNCNS100	J. Collection WM Wide Calf Kne Chestnut 10                                                           
4NLSHCNBRS080	J. Collection WM Wide Calf Stu Brown 8                                                               
4NLSHFNBRS095	J. Collection WM Wide Calf Slo Brown 9.5                                                             
4NLSHHNTNS070	Vance Co. MN Faux Suede Oxford Tan 7                                                                 
4NLVMHNBLS090	Hurricane II Rubber Rain Boot Black 9                                                                
4NLZAKNBLS070	Minnetonka Women's Gypsy Sanda Black 7                                                               
4NM109NWHS080	Mountrek WM Snap Creek WaterSh White 8                                                               
4NM1PGNVMS085	NB WM 711v3 Training Navy Multi 8.5                                                                  
4NM4XTNBLS105	Naturalizer Women's Taimi Sand Black 10.5                                                            
4NM5A2NSHS105	Sperry Men's A/O 2-Eye Boat Sh Sahara 10.5                                                           
4NM5CCNTNS105	Sperry Men's Decoy Chelsea Wat Tan 10.5                                                              
4NM5HLVKPS050	Merrell Snow Quest Snow Boot Black-Purple 5                                                          
4NM5U7NBLS085	KEDS Women's SCOUT SPLASH Black 8.5                                                                  
4NM6SZNTNS130	Durango Men's Rebel Boot Tan 13                                                                      
4NM6T1NBLSPMH	Acorn Women's Chinchilla Colla Black M (6.5-7.5)                                                     
4NM7C9GYDS090	Timberland WM Kellis Ankle Boo Dark Grey 9                                                           
4NM7DFNRNS095	Timberland WM Leighland Waterp Medium Brown 9.5                                                      
4NM8B0BLUS080	JCollection WM Faux Suede Boot Blue 8                                                                
4NM8B6NCHS100	SK WM Flex Appeal 2.0 Bold Mov Charcoal 10                                                           
4NMACZNNTS070	GC Shoes Women's Slinky Sandal Natural 7                                                             
4NMI9HNBRS105	Ariat MN Sierra Saddle Steel T Brown 10.5                                                            
4NMI9INBRS130	Ariat MN Groundbreaker Pull On Brown 13                                                              
4NMI9KNBRS110	Ariat MN Groundbreaker Pull On Brown 11                                                              
4NMIC7NDBS080	Wolverine MN Floorhand Waterpr Dark Brown 8                                                          
4NMIDBNDBS100	Wolverine MN Cabor EPX Waterp Dark Brown 10                                                          
4NMJ3LREDS095	Lugz Women's Empire Hi Velvet Boot Teal 9.5                                                          
4NMJAINBLS130	LUGZ MEN EMPIRE LO WR BOOT Black 13                                                                  
4NMJH9NMTS095	Lugz MEN BOOMER CASUAL SHOE Black-Multi 9.5                                                          
4NMJIJNBLS090	Lugz WOMEN EMPIRE HI FUR BOOT Black 9                                                                
4NMTG9NHCS090	Bearpaw Women's Krystal Fringe Hickory 9                                                             
4NMTI9NBLS090	JCollect WM Faux Suede  Flats Black 9                                                                
4NMTJPNGRS090	JCollection WM Cut-out Ankle B Gray 9                                                                
4NMU5NNGRS105	adidas neo MN Raleigh 9TIS Mid Gray 10.5                                                             
4NMYYZNEKS105	Puma MN Tazon Modern SL FM White-Black 10.5                                                          
4NMYZOBWHS090	Puma WM Vikky Suede Blue-White 9                                                                     
4NN00HNBLS110	KENNETH COLE REACTION MEN'S DE Black 11                                                              
4NN4U3NCGS090	Fergalicious Women's Wicket Bo Cognac 9                                                              
4NN4U7NSAS080	Fergalicious Women's Tootsie B Sand 8                                                                
4NN4UZNSAS080	Fergalicious Women's Bata Boot Sand 8                                                                
4NN5PANBLS085	XOXO Women's MADRID BOOT Black 8.5                                                                   
4NN6HQNCGS085	Fergalicious Women's Lexis Boo Cognac 8.5                                                            
4NN7IQNBLS060	REPORT WMN EDLYN Bootie Black 6                                                                      
4NN7ISNBRS100	Skechers Easy Going Quantum Bo Brown 10                                                              
4NNA1ZAPYS045	NB Kids 775v1 Running Pink-Yellow 4.5                                                                
4NNAVPNTPS100	JCollect. WM Chunky Heel Strap Taupe 10                                                              
4NNDBENBLS065	Naturalizer Women's Brelynn We Black 6.5                                                             
4NNE0PNHCS080	Bearpaw Women's Rosalina Mocca Hickory 8                                                             
4NNEK9NBLS130	Merrell Men's Moab Adventure M Black 13                                                              
4NNKKZNBLS080	JC WM Laser Cut Tassle Bootie Black 8                                                                
4NNKKZNTPS090	JC WM Laser Cut Tassle Bootie Taupe 9                                                                
4NNMHOBNVS080	SKECHERS Women's BOULDER WATER Navy 8                                                                
4NNP5DNBLS130	Ariat Men's Sport Western Wide Black 13                                                              
4NNP6INBRS095	Ariat Men's Heritage Roughstoc Brown 9.5                                                             
4NNQUANGRS120	JCollect WM Shay Side Slit Buc Gray 12                                                               
4NNR1ANBLS095	Naturalizer Women's Jenelle Bo Black 9.5                                                             
4NNV15NBRS100	Rocky Men's 8" Work Maxx Water Brown 10                                                              
4NNVR9VMLS060	NB WM Arishi Run Mulberry 6                                                                          
4NNVX8NBRS080	MINNETONKA Women's BRENNA BOOT Brown 8                                                               
4NNVXRNBRS095	Minnetonka Women's El Paso II  Brown 9.5                                                             
4NNX35NBLS085	GC Shoes Women's Dustin Boot Black 8.5                                                               
4NNX37NBRS080	GC Shoes Women's Randi Boot Brown 8                                                                  
4NNXCDNCNS075	JC WM Walla Ankle-Strap Knee-H Chestnut 7.5                                                          
4NNXCGNBLS100	JC WM Walla Wide-Calf Ankle-St Black 10                                                              
4NOAD3NBRS070	Easy Street Women's Carlita Wi Brown 7                                                               
4NOAEDNBLS085	Easy Street Women's Maxwell Bo Black 8.5                                                             
4NOB0LNBLS095	LUCKY BRAND WM Lahela BOOTIE Black 9.5                                                               
4NOCBDNGRS080	MUK LUKS Women's Jean Boots Gray 8                                                                   
4NOCBEDKHS100	MUK LUKS Women's Patti Boots Dark Grey Heather 10                                                    
4NOCBENBRS090	MUK LUKS Women's Patti Boots Brown 9                                                                 
4NOCBENBRS090	MUK LUKS Women's Patti Boots Brown 9                                                                 
4NOCBTNCAS070	MUK LUKS Women's Cheryl Boots Camel 7                                                                
4NOCEONBLS070	Naturalizer Women's Dora Boot Black 7                                                                
4NOCEZNBLS070	Naturalizer Women's Kala Boot Black 7                                                                
4NODQENTNS130	Dan Post Men's Armstrong Steel Tan 13                                                                
4NODXPNAYS115	CAT Footwear Men's Navigator M Clay 11.5                                                             
4NODXPNAYS115	CAT Footwear Men's Navigator M Clay 11.5                                                             
4NOG0ENBLS100	Journee Collection Womens Embr Black 10                                                              
4NOG0SNBLS100	Journee Collection WM Kalani D Black 10                                                              
4NOG0SYGOS055	Journee Collection WM Kalani D Gold 5.5                                                              
4NOGENNBLS100	Journee Colleciton Womens Gyps Black 10                                                              
4NOGHBNTPS085	Journee Collection Womens Mage Taupe 8.5                                                             
4NOGK6NBLS100	MUK LUKS Men's Max Shoes Black 10                                                                    
4NOGLTBDNSL10	MUK LUKS Women's Amira Slippe Denim L (9-10)                                                         
4NOGMQNCHS090	MUK LUKS Women's Megan Boots Charcoal 9                                                              
4NOGMYNGRS080	MUK LUKS Women's Shawna Boots Gray 8                                                                 
4NOGXJNBLS085	Carlos by Carlos Santana Women Black 8.5                                                             
4NOGZ8GOLS090	Journee Collection Womens Quel Olive 9                                                               
4NOK49NGRS095	Journee Collection WM Jester-0 Gray 9.5                                                              
4NOK5BNGRS080	Journee Collection WM Carver M Gray 8                                                                
4NOK5DNBRS080	Journee Collection WM Jayne Mi Brown 8                                                               
4NOK5PNBLS090	Journee Collection WM Jester-0 Black 9                                                               
4NOK81NBLS070	JOSMO BOYS BOATS SHOES Black 7                                                                       
4NOK8RNBLS060	JOSMO  GIRLS TODDLER   BOOTS Black 6                                                                 
4NOL2SNBLS095	Sperry WM Gold Cup Ava Wedge B Black 9.5                                                             
4NOLBTNBLS090	Cougar WM Dart WP Boot Black 9                                                                       
4NOLH6NBLS040	Journee Kid's Lassy Boots Black 4                                                                    
4NOLJSNBYS100	Bearpaw WM Gwyneth 12" Quilted Black-Gray 10                                                         
4NOLJYNCHS060	Bearpaw WM Celine Boot Charcoal 6                                                                    
4NOLJYNWHS110	Bearpaw WM Celine Boot White 11                                                                      
4NOLJZNHCS100	Bearpaw WM Aretha Boot Hickory 10                                                                    
4NOLW7NBLS080	Skechers Womens Parallel Tripl Black 8                                                               
4NOLXCNBLS090	Skechers Womens Reggae Fest-Fo Black 9                                                               
4NOLXIBLUS090	PUMA MN SUEDE CLASSIC MID Blue 9                                                                     
4NOMM2NBTS095	GC Shoes WM August Quilted Rid Black-Tan 9.5                                                         
4NU060NBLS080	Bearpaw WM Boetis Boot Black 8                                                                       
4NU706NBRS070	Georgia MN Romeo Work Shoe-Wid Brown 7                                                               
4NV364NTNS120	John Deere MN 5" Hiker Boot-W Tan 12                                                                 
4NW299NBRS105	Durango Mens Farm n Ranch Boot Brown 10 1/2                                                          
4PB110NWTS120	TimbrlndPRO MN 6"SteelToe Boot Wheat 12                                                              
4PT745NBRS070	Skechers WM Unlmtd LaceUp Boot Brown 7                                                               
4QD890WBLK020	Bearpaw Kids Abigail toggle bt Black 2                                                               
4QE838NDBS060	TmbrlndEK MountHope LthrFbrcBt Dark Brown 6                                                          
4QE987NONK120	Itasca Youth SnowStomper Boot Camo-Brown 12                                                          
4QH864NWTS060	Timberland WM 6" Premium Boot Wheat 6                                                                
4QH864NWTS065	Timberland WM 6" Premium Boot Wheat 6 1/2                                                            
4QH864NWTS095	Timberland WM 6" Premium Boot Wheat 9 1/2                                                            
4QH931NWTS090	Timberland WM 6"Premium Bt W Wheat 9                                                                 
4QN155BLTS130	Rocky Iron Clad 9" LTT ST Wide Brown Leather 13                                                      
4QQ058BLTS080	Rocky Aztec Pull-On PT Med Brown Leather 8                                                           
4QQ059NBLS085	Rocky Alpha Force 6" Wide Black 8 1/2                                                                
4QQ059NBLS140	Rocky Alpha Force 6" Wide Black 14                                                                   
4QR915NDBS100	Durango MN Patriotic Boot W Dark Brown 10                                                            
4QU730NWTS095	Timb WM Nellie Chukka WP Bt Wheat 9 1/2                                                              
4QY036AWFK065	PUMA JR ROMA BASIC White-Fuchsia 6.5                                                                 
4RG845NHCS080	Bpaw DESDEMONA waterproof bt Hickory 8                                                               
4RJ154NBLS090	SK MN Felton Work RF SR- M Black 9                                                                   
4RJ161NBRS090	SK MN Work Shire 6''ST boot Brown 9                                                                  
4RM086NBLS085	Tland MN Icon 6" Basic Boot Black 8 1/2                                                              
4RM086NBLS090	Tland MN Icon 6" Basic Boot Black 9                                                                  
4RM086NWTS115	Tland MN Icon 6" Basic Boot Wheat 11 1/2                                                             
4RM093BLKS095	Tland MN Icon Wtrprf Chukka Black-Black 9.5                                                          
4RM093NBRS105	Tland MN Icon Wtrprf Chukka Brown 10 1/2                                                             
4RN922NCTS055	SK WN BOBS Rain Dance Chocolate 5 1/2                                                                
4SG957BLSS080	Lugz MN Empire Lo Boot Black Scuff 8                                                                 
4SG957NWTS080	Lugz MN Empire Lo Boot Wheat 8                                                                       
4SK296NBRS085	DP MN TEMPE OSTRICH BOOT Brown 8.5                                                                   
4SK305NBLS090	DAN POST MN RALEIGH LIZARD BT Black 9                                                                
4SK305NBLS100	DAN POST MN RALEIGH LIZARD BT Black 10                                                               
4SL805NBLS120	SK MN CITYWALK- MALTON Black 12                                                                      
4SN383NBRS085	Carhartt WORK FLEX 6" COMP W Brown 8 1/2                                                             
4SV201NBLS120	NB MN 813HV1 WALKING Black 12                                                                        
4TJ915NBRS100	Ariat MN SPORT WIDE SQUARE TOE Brown 10                                                              
4TJ915NBRS105	Ariat MN SPORT WIDE SQUARE TOE Brown 10.5                                                            
4TP670NBLS120	NB MN 813V1 walking oxford-ext Black 12                                                              
4TQ169NBLS050	LUGZ WM Zen LO BOOT Black 5                                                                          
4TQ169NCNS060	LUGZ WM Zen LO BOOT Chestnut 6                                                                       
4TQ169NCNS100	LUGZ WM Zen LO BOOT Chestnut 10                                                                      
4UT471NBYS060	Bearpaw WM Bethany WP Boot Black-Gray 6                                                              
4UT475NCHS060	Bearpaw WM Boo Curly Lamb Boot Charcoal 6                                                            
4F44470000010	Retinol Day Cream                                                                                    
4F70450000010	Lds Fire & Ice 1.7oz CologneSp                                                                       
4NB6Q30000010	SECRET OBSESSION For Women EDP                                                                       
4NBULNNBL0010	Cosmetic Organizing Carousel - Black                                                                 
4NCBP00000010	Truly Pink Eau De Parfum Spray                                                                       
4NCBXU0000010	SAND AND SABLE For Women COLOG                                                                       
4NCBXU0000010	SAND AND SABLE For Women COLOG                                                                       
4NCGYA0000010	Laila Ali Salon Ionic Dryer                                                                          
4NCGYA0000010	Laila Ali Salon Ionic Dryer                                                                          
4NCMIM0000010	Blood Pressure Monitor with ca                                                                       
4NDQCB0000010	Evertone Fat Freezer Belt                                                                            
4NEBEH0000010	Verseo EyeSpa                                                                                        
4NF8BP0000010	Heat Massager                                                                                        
4NGE4E0000010	Instyler Max Zebra Pink                                                                              
4NGE4E0000010	Instyler Max Zebra Pink                                                                              
4NGQ3M0000010	Strivectin 360 Tightening Eye                                                                        
4NHUEP0000010	Chloe by Parfums Chloe for Wom                                                                       
4NI3490000010	Interplak Dental Water Jet                                                                           
4NJBBB0000010	Simply Straight Pro                                                                                  
4NJZ060000010	InStyler IONIC STYLER Ceramic                                                                        
4NK6Q7NBL0010	Reflexology Foot Massager with Black                                                                 
4NK8MI0000010	Infiniti Pro Gold Series AC Mo                                                                       
4NK8MI0000010	Infiniti Pro Gold Series AC Mo                                                                       
4NKF9ANGR0010	Fast Tech Fusion Straightening Gray                                                                  
4NKXMQ0000010	Electronic Pulse Massager with                                                                       
4NKYCW0000010	Escape For Women Eau De Parfum                                                                       
4NKZR70000010	Burberry Body For Women Eau De                                                                       
4NL8IF0000010	Instyler Max 3 Piece Essential                                                                       
4NLE970000010	Diamond Brilliance Shine Syste                                                                       
4NMKMHNWH0010	Bluestone Rechargeable Sonic T White                                                                 
4NMRS00000010	Wahl Lithium Ion Multigroom Ki                                                                       
4NN2I30000010	Epilady Esthetic Generation 5                                                                        
4NN4MD0000010	Juicy Couture Viva La Juicy 3p                                                                       
4NN4MJ0000010	Ed Hardy Women's 2pc Set                                                                             
4NN4NF0000010	Ed Hardy Duo Set for Men                                                                             
4NN4S00000010	Weight Watchers Bluetooth Body                                                                       
4NN4SM0000010	Wahl Heated Foot Massage                                                                             
4NN4SM0000010	Wahl Heated Foot Massage                                                                             
4NN5UU0000010	Zadro LED Lighted Dual Sided V                                                                       
4NNGJK0000010	Waterpik Complete Oral Care                                                                          
4NNLIF0000010	Jimmy Choo Man Eau De Toilette                                                                       
4NNQ730000010	Prevari Shiatsu Neck & Back Massager with Heat                                                       
4NNQ730000010	Prevari Shiatsu Neck & Back Massager with Heat                                                       
4NNU1D0000010	Prevari All That Glitters 75 Pc Cosmetics Train Ca                                                   
4NNXF60000010	Prevari 10 Motor Massage Cushion with                                                                
4NOMKT0000010	Digital Glass Scale                                                                                  
4NP1260000010	Lumiscope Dlx Blood Pressure                                                                         
4NW3290000010	Andis Pro Motor 27pc Hair Clipper/Trimmer Combo                                                      
4NW3710000010	Interplak Sonic Water Jet Sys                                                                        
4P14300000010	Wahl 30pc Home Barber Kit                                                                            
4P32870000010	Lds CoolWater 1OZ EDT Spray                                                                          
4PC9030000010	Compression Knee Wrap                                                                                
4PF2880000010	Veridian Sport Digital Blood Pressure Monitor                                                        
4PF3970000010	Veridian Pulse Oximeter                                                                              
4PG1300000010	Comfort Products Manicure and Pedicure System                                                        
4PL2650000010	Conair ThermaLuxe Massaging Heating Pad                                                              
4PL2740000010	Conair Neck/Back Massager                                                                            
4PL6080000010	HoMedics Massage Cushion                                                                             
4PR2370000010	Conair Xtreme Instant Heat Ceramic Hot Rollers                                                       
4QJ908VUP0010	Infiniti Pro 1875W AC Dryer Purple-Pink                                                              
4QJ908VUP0010	Infiniti Pro 1875W AC Dryer Purple-Pink                                                              
4QJ908VUP0010	Infiniti Pro 1875W AC Dryer Purple-Pink                                                              
4QJ908VUP0010	Infiniti Pro 1875W AC Dryer Purple-Pink                                                              
4QJ908VUP0010	Infiniti Pro 1875W AC Dryer Purple-Pink                                                              
4QK487VDU0010	Conair Pro Curl Secret Deep Purple                                                                   
4QK487VDU0010	Conair Pro Curl Secret Deep Purple                                                                   
4QK487VDU0010	Conair Pro Curl Secret Deep Purple                                                                   
4QK651RPK0010	Conair Hot/Cold Facial Sauna Pink                                                                    
4QK651RPK0010	Conair Hot/Cold Facial Sauna Pink                                                                    
4QQ9610000010	Epilady EstheticFacialHairEpilator                                                                   
4RU764VPR0010	Wahl Grooming Kit for Ladies Purple                                                                  
4N94740000010	7 - 9 Inch Salt Lamp                                                                                 
4NBBPZ0000010	McLeland 3pc table set                                                                               
4NBLU10000010	Foot Stool - Oak                                                                                     
4NBZ8GBSB0010	Sky Blue Faux Leather Parson C Sky Blue                                                              
4NDLNZNOW0010	alcFridaOriental5pcSet off white                                                                     
4NFR3MRED0010	alcove Trenton 3 PC Rug Set Red                                                                      
4NFUT9NML0010	Wall Dcor-Branch w/ Leaves Multi                                                                     
4NFUT9NML0010	Wall Dcor-Branch w/ Leaves Multi                                                                     
4NFYIWMSL0010	Metallic Curtain Panels Silver                                                                       
4NFYIWMSL0010	Metallic Curtain Panels Silver                                                                       
4NI3CGGCR0010	Sunbrella Soft Comfort Cushion Citron                                                                
4NIVRENBR0010	McLeland Bennett Reclining Sof Brown                                                                 
4NIVRENBR0010	McLeland Bennett Reclining Sof Brown                                                                 
4NIYDNNCD0010	Duck Covers Elite 34 in. Squar Cappuccino                                                            
4NK5F50000010	McLeland Walnut TV Stand                                                                             
4NK8KFRCE0010	Small Monitor Riser-Cherry Cherry                                                                    
4NKS670000010	Stained Glass Butterfly Accent                                                                       
4NKSCUGLE0010	Big Joe Dorm Radiant Orchid Sm Lime                                                                  
4NKWLENBR0010	Live-Laugh-Love Wooden Wall Ha Brown                                                                 
4NLIHF0000010	Pillow Rest Raised 16.5" Airbe                                                                       
4NLIHF0000010	Pillow Rest Raised 16.5" Airbe                                                                       
4NLIHI0000010	Comfort Plush 22" Airbed Queen                                                                       
4NLIHI0000010	Comfort Plush 22" Airbed Queen                                                                       
4NLIHI0000010	Comfort Plush 22" Airbed Queen                                                                       
4NLLFU0000010	10" Alpine Chic Red and White                                                                        
4NLO43NIV0010	alc Faux Flokati Sheepskin 60  Ivory                                                                 
4NLQZ50000010	McLeland Shutter Floor Cabinet                                                                       
4NLUDCNGR0010	Superior Hand Woven Natural Fi Gray                                                                  
4NLW9BNBL0010	Darth Vader Mister Machine Black                                                                     
4NMI07NML0010	Sugar Skulls Boho Golds Graphi Multi                                                                 
4NMP3FBLU0010	Tuscany by Joval Canvas Art 14 Blue                                                                  
4NMPRGNGR0010	Michael de Guzman 'Withstand'  Gray                                                                  
4NMQTR0000010	Veranda Coffee Table Cover Rec                                                                       
4NMY6NNGR0010	Belaire End Table, Weathered G Gray                                                                  
4NT7820000010	McLeland Design Braden 2 Pc. Lamp Set                                                                
4PK473NEX0010	alcove Storage Ottoman Espresso                                                                      
4QC180NTP0010	San Juan Sofa Cover Taupe                                                                            
4QQ6040000010	alcove 4panel Fold room divider                                                                      
4RR635NWH0010	ALC S/2 Paris Trunks White                                                                           
4SJ746NBR0010	ALCOVE LAP TOP DESK Brown                                                                            
4ST284RED0010	LIN Medallion 4 pc Rug Red                                                                           
4SV2130000010	Table Lamp                                                                                           
4UT861NBL0010	Allegra Pillowtop Futon Black Black                                                                  
4N41660010	10x20 6 Leg Canopy                                                                                   
4N47730000010	Leaf Collector                                                                                       
4N47760000010	Toro Spring Bucket                                                                                   
4NA1FW0000010	Master Craft Impact Wrench wit                                                                       
4NBFQTMCH0010	ASHLAND LAUNDRY FAUCET PC Chrome                                                                     
4NBW6P0000010	Hygrostat sensor humidifier                                                                          
4NBW6P0000010	Hygrostat sensor humidifier                                                                          
4NE1630000010	7pc Pliers Set                                                                                       
4NE5W20000010	Ultrasonic aroma diffuseur-Hum                                                                       
4NGXSX0000010	Drill Press Station                                                                                  
4NH8950000010	Stanley 5 GAL Wet/Dry Vac                                                                            
4NI1770000010	Optimus 9" Dish Heater                                                                               
4NI1770000010	Optimus 9" Dish Heater                                                                               
4NI1770000010	Optimus 9" Dish Heater                                                                               
4NI1770000010	Optimus 9" Dish Heater                                                                               
4NIGMK0000010	Master Craft 3500 Peak/3000 Ru                                                                       
4NIOE80000010	Callen Petite Foyer Fireplace                                                                        
4NIRD30000010	Instant Garage Framer Kit                                                                            
4NIRDNRED0010	Corded 12 Amp 16 Inch Snow Pow Red                                                                   
4NIVQ10000010	Richmond IR Stove                                                                                    
4NIVQ10000010	Richmond IR Stove                                                                                    
4NIVQUNW70010	Camden IR Fireplace Insert Walnut                                                                    
4NJODA0000010	Stanley Big Space 19IN METAL                                                                         
4NLS6Y0000010	Char-Broil Classic 2-Burner 28                                                                       
4NMG1T0000010	Vie Air 9" High Velocity Tilti                                                                       
4NMGW80000010	Real Flame Devin Electric Fire                                                                       
4NMGWT0000010	Real Flame Holbrook Electric F                                                                       
4NN8HO0000010	Mini Refrigerator                                                                                    
4NNVWO0000010	9PC 3/8" DR. SAE 6PT DEEP SOCK                                                                       
4NNZHA0000010	Milwaukee Tools M18 Hackzall                                                                         
4NOJRFYEL0010	DeWalt 20V MAX Li-Ion Compact  Yellow                                                                
4NON8A0000010	Firman 1050 Watts Generator                                                                          
4NT2860000010	Garage/Shop Utility Heater                                                                           
4PF1180000010	M.C. 3.5 HP10GallonCompressor                                                                        
4PQ9910000010	Sunpentown Mini Thermo Electric Dehumidifier                                                         
4QB4450000010	Master Craft 7500 Watt Dual Fuel Generator                                                           
4QC5720000010	Infrared Quartz Radiant Heater                                                                       
4QE9690000010	Medium Duty Paint Sprayer                                                                            
4RW2710000010	10 Gal S/steel Wet/dry Vac                                                                           
4SB0640000010	MC 2700 PSI Gas Press Washer                                                                         
4SL074NBL0010	24" Tool Chest & Cabinet Combo Black                                                                 
4SL1720000010	5PC. BLACK FIRESET                                                                                   
4UP6550000010	20V MAX* Lithium Compact Drill                                                                       
4F10440000010	G Foreman Indoor/Outdoor Grill                                                                       
4H58740000010	Dual ProFry Deep Fryer                                                                               
4H58740000010	Dual ProFry Deep Fryer                                                                               
4H9049GPS0010	Kitchenaid Stand Mixer-Pistachio                                                                     
4J4339NBL0010	Alcove Double Cereal Dispenser-Black                                                                 
4J67460000010	Stove Top Smoker                                                                                     
4J74690000010	Knitting Machine                                                                                     
4N22960010	Jumbo ProFry Basket                                                                                  
4NA1F5NEX0010	alcove Over the Sink Organizer Espresso                                                              
4NA1MI0000010	alcove Deluxe Adjustable Garme                                                                       
4NA70A0000010	Chef?s Mark 4-Slice Wide-Slot Large Capacity Toast                                                   
4NA7Z40000010	Chef's Mark electric Pressure                                                                        
4NA7Z40000010	Chef's Mark electric Pressure                                                                        
4NA7ZI0000010	alcove Novelty Popcorn Machine                                                                       
4NA7ZXNGR0010	16pc Mcleland Reactive glaze D Gray                                                                  
4NA7ZXNGR0010	16pc Mcleland Reactive glaze D Gray                                                                  
4NA8VC0000010	48pc Alcove Cutlery set with g                                                                       
4NA8VC0000010	48pc Alcove Cutlery set with g                                                                       
4NB37I0000010	NuWave Pro Plus Oven with Exte                                                                       
4NB37I0000010	NuWave Pro Plus Oven with Exte                                                                       
4NBA840000010	George Foreman 6-Serving Grill                                                                       
4NBG5F0000010	20 Piece Glass Bowl Set                                                                              
4NBG5F0000010	20 Piece Glass Bowl Set                                                                              
4NBG7ZMTT0010	Trisha Yearwood Cottage Precio Titanium                                                              
4NBJD00000010	AsSeenOnTV Hurricane Spin Mop                                                                        
4NBUNN0000010	Pair Floor Shoe Tower                                                                                
4NC9D7BLU0010	Pfaltzgraff Everyday Harmony C Blue                                                                  
4NCOH10000010	Chef's Mark 16" Jumbo Electric skillet red                                                           
4NCOHW0000010	Chef's Mark Food Dehydrator                                                                          
4NDQOUMSS0010	Keurig Stainless Steel Travel-Stainless-                                                             
4NE1700000010	Elite Multi-Function Toaster Oven                                                                    
4NE1700000010	Elite Multi-Function Toaster Oven                                                                    
4NE6580000010	Presto Eversharpe Knife Sharpe                                                                       
4NF8UE0000010	Keurig 2.0 My K-Cup Reusable                                                                         
4NFR57RED0010	KEURIG 2.0 K250 BREWING SYSTE Red                                                                    
4NFR58RED0010	KEURIG 2.0 K475 BREWING SYSTE Red-DNU                                                                
4NGA6N0000010	Better Chef 16-Inch Chrome Dis                                                                       
4NGJQCNBL0010	PerfectCooker Black                                                                                  
4NHB5C0000010	Rug Doctor Portable Spot Clean                                                                       
4NHB5C0000010	Rug Doctor Portable Spot Clean                                                                       
4NI6840000010	alcove 12pc NonStick Bkwre                                                                           
4NI8HD0000010	Farberware 12-CUP STAINLESS ST                                                                       
4NIXKM0000010	Bissell Zing Bagless Canister                                                                        
4NIXKM0000010	Bissell Zing Bagless Canister                                                                        
4NIXKM0000010	Bissell Zing Bagless Canister                                                                        
4NJN750000010	Dirt Devil Power Flex Pet Bagl                                                                       
4NJUAP0000010	Cuisinart Pro Food Slicer                                                                            
4NJUF60000010	Dirt Devil Flipout Lithium Pow                                                                       
4NJXGJ0000010	West Bend Theater Popcorn Mach                                                                       
4NJZ7S0000010	Hamilton Beach 3-in-1 Electric                                                                       
4NK58G0000010	8qt Alcove Manual Slow Cooker,                                                                       
4NK58J0000010	Alcove 3pc S/S kitchen organiz                                                                       
4NK6QH0000010	Alcove 36" closet                                                                                    
4NK6QH0000010	Alcove 36" closet                                                                                    
4NKK480000010	Butterball 14lb Indoor Electric Turkey Fryer                                                         
4NLAEU0000010	Kamenstein 20 Jar Revolving Sp                                                                       
4NLBC00000010	Gotham Steel 10 pc Nonstick Co                                                                       
4NLOHA0000010	HomeRight SteamMachine Model 5                                                                       
4NLOHA0000010	HomeRight SteamMachine Model 5                                                                       
4NLOOVNBL0010	Power Air Fryer XL 3.4-qt. Black                                                                     
4NLOOXNBL0010	Power Air Fryer XL 5.3-qt. Black                                                                     
4NLOOXNBL0010	Power Air Fryer XL 5.3-qt. Black                                                                     
4NLOOXNBL0010	Power Air Fryer XL 5.3-qt. Black                                                                     
4NLOOXNBL0010	Power Air Fryer XL 5.3-qt. Black                                                                     
4NLOOXNBL0010	Power Air Fryer XL 5.3-qt. Black                                                                     
4NLOOXRED0010	Power Air Fryer XL 5.3-qt. Red                                                                       
4NLOOXRED0010	Power Air Fryer XL 5.3-qt. Red                                                                       
4NM7GC0000010	Power Pressure Cooker XL 8qt                                                                         
4NM7GE0000010	Power Pressure Cooker XL 10qt                                                                        
4NMMQQ0000010	Oneida 8qt Stock Pot                                                                                 
4NMOIH0000010	Copper Chef 3-Pack Fry Pan Set                                                                       
4NN26O0000010	IMUSA LCI-19008 14-Inch Lightw                                                                       
4NN2OP0000010	Dirt Devil Power Express Lite                                                                        
4NN3100000010	Bissell SpotBot Pet                                                                                  
4NNE970000010	Pop Crazy Popcorn Kernels and                                                                        
4NNGQPNBL0010	Chef?s Mark 5pc Cast Iron Ckwr Set                                                                   
4NNGQPNBL0010	Chef?s Mark 5pc Cast Iron Ckwr Set                                                                   
4NNPMPMSS0010	Gourmia 10 in 1 Sous Vide Mult Stainless                                                             
4NNVDKRED0010	Proctor Silex Programmable 12  Red                                                                   
4NOD5J0000010	Hamilton Beach Programmable Co                                                                       
4NOD5O0000010	Hamilton Beach Programmable Ea                                                                       
4NON920000010	Nostalgia Retro Series 6-Slice                                                                       
4NON920000010	Nostalgia Retro Series 6-Slice                                                                       
4NOOY40000010	George Foreman Indoor/Outdoor                                                                        
4NP2240000010	Oster Baldwyn 22pc SS Cutlery Set                                                                    
4NS8310000010	Oval Lid 21 Gallon Motion Sensor Trashcan                                                            
4NS8310000010	Oval Lid 21 Gallon Motion Sensor Trashcan                                                            
4NS8440000010	Round Lid 13 Gallon Motion Sensor Trash Can                                                          
4NV9280000010	H2O Mop X5 5-in-1 Cleaning Machine/Steamer                                                           
4NW059NBL0010	Elite 13 Func Pressure Cookr Black                                                                   
4P13190000010	Bissell Powerlifter Powerbrush                                                                       
4P13190000010	Bissell Powerlifter Powerbrush                                                                       
4P13190000010	Bissell Powerlifter Powerbrush                                                                       
4P2181NBL0010	Ginsu 14pc Cutlery/5 Colors Black                                                                    
4PA0740000010	Presto 11" Electric Skillet w/Glass Lid                                                              
4PL1630000010	Dirt Devil Jaguar Pet Bagless Upright Vac                                                            
4PL1630000010	Dirt Devil Jaguar Pet Bagless Upright Vac                                                            
4PU781MSS0010	Chef's Mark Metal Window Canisters Set Stainless                                                     
4PW0310000010	AirBake by Tfal 3pc Bakeware Set                                                                     
4PZ0860000010	Waring Tailgater Blender                                                                             
4PZ4990000010	WindTunnel 2 High Capacity Pet                                                                       
4PZ5060000010	Hoover WindTunnel 3 Pro Pet 12Amp Upright Vacuum                                                     
4QH3280000010	4-Slice Toaster Oven                                                                                 
4QH3940000010	Chefs Mark Elec Meat Grinder                                                                         
4QK2230000010	6 qt SS Pressure Cooker                                                                              
4QQ267000MNGS	alcove 66pc Beaded Monogram  S                                                                       
4QX7180000010	U-T-BED SHOE BOX 12PR BK+CRM                                                                         
4RC723RCM0010	Hoover PetPowerScrub DeepCleaner Crimson                                                             
4RD195NWH0010	ChefsMark Ice Maker - Silver                                                                         
4RD195NWH0010	ChefsMark Ice Maker - Silver                                                                         
4RD196NBL0010	ChefsMark Deluxe Juicer (5.2L) Black                                                                 
4RF2280000010	Corelle Splendor Sq 16p Dinnerware Set                                                               
4RG715ORG0010	12-Piece Cookware Set Orange                                                                         
4RG718RED0010	12-Piece Cookware Set Red                                                                            
4RJ722NBR0010	Nost 4QT Wooden Ice Cream Maker Brown                                                                
4RK734RED0010	alcove 16pc Dinnerware Set Red                                                                       
4RM9560000010	Hamilton 2Way FlexBrew Coffeemaker                                                                   
4RU405MSL0010	Magic Chef Portable Ice Maker Silver                                                                 
4SH7690000010	Bella Rotating Waffle Maker                                                                          
4SS068NB30010	Biss Cleanview Complt Pet Vac Black-Red                                                              
4UL7390000010	Presto ExtraLarge Flexible Nylon Pancake Turner                                                      
4NBWYHNWH0010	Double Sided Swing Down Bed Ra White                                                                 
4NI00ABLU0010	SPLISH N SPLASH TUB -PINK Blue                                                                       
4NIX9I0000010	Portable BabySuite DLX Spearmi                                                                       
4NK2TC0000010	Dreambaby Portable Booster Hi                                                                        
4NKSGLNBL0010	Graco 4Ever All in 1 Car Seat Studio                                                                 
4NMKU5TEY0010	Deluxe Sit, Snack & Go Booster Teaberry                                                              
4NMKVFNML0010	Deluxe Sit, Snack & Go Booster Multi                                                                 
4NMKVFNML0010	Deluxe Sit, Snack & Go Booster Multi                                                                 
4NOFXV0000010	MobyWrap MayaMax 6n1 Cover and Go Eco                                                                
4NOFXV0000010	MobyWrap MayaMax 6n1 Cover and Go Eco                                                                
4NOFXV0000010	MobyWrap MayaMax 6n1 Cover and Go Eco                                                                
4NOP6Z0000010	Chicco Lullaby Baby Playard -                                                                        
4SH0970000010	Minnie Mouse Canopy Bed                                                                              
4TE2210000010	Glider Lite Gliding Swing                                                                            
4H38070000010	Gold Plated 7 Pair Hoop Earring Set                                                                  
4N5643000J010	GT 5 Piece CZ Ring Set-10                                                                            
4NB4RH000J007	GP 8mm RND-cut CZ w/ Side ston 7                                                                     
4NB4RV000J007	GP Elegant 8mm RND-cut CZ w/ S 7                                                                     
4NB611000J009	Mens TT Steel Pyramid Brace/Rg 9                                                                     
4NBUEEBAC0010	MLB Letterman Sport w Cubs                                                                           
4NBUXF000J007	Gold Plate Cubic Zirconia Wate 7                                                                     
4NBUXK000J009	Gold Plate Cubic Zirconia Marq 9                                                                     
4NBUXK000J010	Gold Plate Cubic Zirconia Marq 10                                                                    
4NCMHD000J012	STS GLD SANCTIFY STRENGTH SET 12                                                                     
4NCOEO0000010	Ashley Princess Elegant Watch & Wallet Set - Black                                                   
4NDBRP0000010	Citizen Men's Perpetual Chrono                                                                       
4NDGQV000J009	YELLOW GOLD AND RHODIUM PLATED  9                                                                    
4NDVTX0000010	BULOVA MENS WATCH                                                                                    
4NEC860000010	MEN'S U.S. ARMY C42 BACKLIGHT                                                                        
4NEC8X0000010	MEN'S U.S. NAVY C20 WATCH BY W                                                                       
4NF9WY0000010	STS CHAIN 6PC NECK AND BRACELE                                                                       
4NFIJX0000010	Nautica Men's NAD16527G NST 11 Analog Displa                                                         
4NFIJX0000010	Nautica Men's NAD16527G NST 11 Analog Displa                                                         
4NH9PH0000010	Gold Plated Diamond Cut Bangle                                                                       
4NH9T8BLU0010	Black IP Case and Top Ring, Bl Blue                                                                  
4NHB020000010	GT ST POST & HOOPS 7ON EAR SET                                                                       
4NHB020000010	GT ST POST & HOOPS 7ON EAR SET                                                                       
4NHB020000010	GT ST POST & HOOPS 7ON EAR SET                                                                       
4NHEVA000S080	18K YELLOW GOLD OVER  BRONZE D 8                                                                     
4NHKYG0000010	ST HOOPS 7PC HOOP EAR SET                                                                            
4NHKYI0000010	GT HOOPS 10 PC HOOP EAR SET                                                                          
4NJJIS0000010	P/G 18K Rose Gold Plated Micro                                                                       
4NJO7L0000010	Bulova Men's Marine Star Chron                                                                       
4NK71Y0000010	Stainless Steel Curb Chain Nec                                                                       
4NKF4SSGA0010	Georgia  Watch Georgia                                                                               
4NKF4VFCB0010	Dallas Cowboys Sparo Cowboys                                                                         
4NKN8R0000010	Stainless Steel Black Ip Cross                                                                       
4NKS2C0000010	Citizen Ladies' Quartz Stainle                                                                       
4NKSQE0000010	J338-December Birthstone Bangl                                                                       
4NKTSJ000S120	STS GP BRACELET RING SET 12                                                                          
4NL6440000010	Ladies Eco-Drive STST 2T Brclt                                                                       
4NL7520000010	Men's Bracelet Watch                                                                                 
4NL99D0000010	Teen Girl Silver 4-piece Watch                                                                       
4NLN96NAG0010	Olivia Pratt Men's Arrow Decor Black-Gold                                                            
4NLN96NSK0010	Olivia Pratt Men's Arrow Decor Silver-Black                                                          
4NLNZ2BLU0010	Olivia Pratt Men's Quality Dec Blue                                                                  
4NLNZ2RCO0010	Olivia Pratt Men's Quality Dec Coral                                                                 
4NLNZ2RHP0010	Olivia Pratt Men's Quality Dec Hot Pink                                                              
4NLNZEBNV0010	Olivia Pratt Women's Denim Lea Navy                                                                  
4NLNZENGR0010	Olivia Pratt Women's Denim Lea Gray                                                                  
4NLO0SRLP0010	Olivia Pratt Women's Silicone  Light Pink                                                            
4NLXMQ0000010	Goldtone Stainless Steel Curb                                                                        
4NNUZN0000010	Movado  - Movado Esperanza Gen                                                                       
4NOBF6MSL0010	Geneve Women's Silver Watch,GW Silver                                                                
4NOBF9YGO0010	Geneve Women's Gold Watch,GW00 Gold                                                                  
4NOBGCPRO0010	Geneve Women's RoseGold/Silver Rose                                                                  
4NOGHGNBLONES	NY London Women's Square Face  Black ONE SIZE                                                        
4NOGNTFPA0010	NFL Knight Watch Patriots                                                                            
4NOGNTFPA0010	NFL Knight Watch Patriots                                                                            
4NOGNTFRA0010	NFL Knight Watch Raiders                                                                             
4NOJ0MNWHONES	Geneva Platinum Women's Matte  White ONE SIZE                                                        
4NP1080000010	STST GldIP Brclt&CrossPndt Set                                                                       
4NP1080000010	STST GldIP Brclt&CrossPndt Set                                                                       
4NP1080000010	STST GldIP Brclt&CrossPndt Set                                                                       
4NT832BAP0010	GmTmYngMnsLicensdMLBRookieWtch Phillies                                                              
4NW1330000010	Mens GT Steel Curb Neck & Brac                                                                       
4NW4010000010	AshleyPrncssIntrchngbleWtchSet                                                                       
4NW4010000010	AshleyPrncssIntrchngbleWtchSet                                                                       
4NW933000J008	GT Steel BLK CZ Bracelet/Ring 8                                                                      
4NX6610000010	Citizen Ladies' Eco-Drive Normandie Bracelet                                                         
4P8374000J007	Lds ST 5-PC Color CZ Ring Set 7                                                                      
4P8374000J008	Lds ST 5-PC Color CZ Ring Set 8                                                                      
4PC620000J008	Two-tone Metal Fashion Ring Set-3pc 8                                                                
4PC620000J010	Two-tone Metal Fashion Ring Set-3pc 10                                                               
4PF7530000010	Goldtone CZ Mens Jesus Pendant                                                                       
4PF7550000010	Goldtone Mens Crucifix Pendant                                                                       
4PM1380000010	Sesame St. Big Bird Slap Watch                                                                       
4PU877000J009	STST Men's 2T CRYSTAL BRAC & RING SET 9                                                              
4PV2800000010	Peugeot Ladies Rosetone & Ceramic Bracelet Watch                                                     
4QA2500000010	Armitron Men's Black Rectangular Strap Watch                                                         
4QA4020000010	Peugeot Ladies Orange Strap Watch                                                                    
4QE675000J008	Stainless Steel Men's CZ Bracelet & Ring Set 8                                                       
4QE675000J009	Stainless Steel Men's CZ Bracelet & Ring Set 9                                                       
4QE675000J010	Stainless Steel Men's CZ Bracelet & Ring Set 10                                                      
4QE675000J010	Stainless Steel Men's CZ Bracelet & Ring Set 10                                                      
4QE675000J011	Stainless Steel Men's CZ Bracelet & Ring Set 11                                                      
4QF405000J008	Stainless Steel Crystal Cross & Ring Set  8                                                          
4QK5990000010	Trax Men's Goldtone Watch & Bracelet Set                                                             
4RA431000J010	10KW CZ 3 Stone Ring 10                                                                              
4RG080000J009	STS GLD IP CRY CROSS&RING SET 9                                                                      
4RG080000J011	STS GLD IP CRY CROSS&RING SET 11                                                                     
4RG080000J012	STS GLD IP CRY CROSS&RING SET 12                                                                     
4RG080000J012	STS GLD IP CRY CROSS&RING SET 12                                                                     
4RL8570000010	Men's 14mm Curb Chain                                                                                
4RL8620000010	Men's 10mm Mariner Chain                                                                             
4RQ515000MNGM	ANGELICA ST INITIAL BRACELET M                                                                       
4RQ515000MNGS	ANGELICA ST INITIAL BRACELET S                                                                       
4RQ517000MNGJ	ANGELICA GT INITIAL BRACELET J                                                                       
4RS8810000010	STS CRYSTAL CROSS/ BRAC/CH SET                                                                       
4RS8810000010	STS CRYSTAL CROSS/ BRAC/CH SET                                                                       
4RW0110000010	Wrist Armor MarinesRD C22Watch                                                                       
4SZ8080000010	18K Gold-Plated Bronze Diamond                                                                       
4SZ8080000010	18K Gold-Plated Bronze Diamond                                                                       
4SZ8080000010	18K Gold-Plated Bronze Diamond                                                                       
4TC169NAGJ008	STS 2T GLD BRAC & RING SET Black-Gold 8                                                              
4TC169NAGJ009	STS 2T GLD BRAC & RING SET Black-Gold 9                                                              
4TC169NAGJ010	STS 2T GLD BRAC & RING SET Black-Gold 10                                                             
4TC169NAGJ011	STS 2T GLD BRAC & RING SET Black-Gold 11                                                             
4TE8190000010	STS GLD PRAYER PEN & 30" CHAIN                                                                       
4TE8190000010	STS GLD PRAYER PEN & 30" CHAIN                                                                       
4TE8190000010	STS GLD PRAYER PEN & 30" CHAIN                                                                       
20K9330010	Free Gift- Surprise Gift                                                                             
20X5500000010	Premium - Cake Decorators Set                                                                        
4F04760000010	Razor E100 Elec Scooter -PINK                                                                        
4H62720000010	125/15/2 Amp Auto Charger                                                                            
4N47360000010	Portable Toilet 5.0G Hold Tank                                                                       
4NA6550000010	Discovery 1100 Metal Detector                                                                        
4NA6550000010	Discovery 1100 Metal Detector                                                                        
4NA95N0000010	LifeMax 2-in-1 Cardio Dual Tra                                                                       
4NA95N0000010	LifeMax 2-in-1 Cardio Dual Tra                                                                       
4NBBXV000AXLG	Rocky Womens Fleece Snow/Black X Large                                                               
4NBCHPNBL0010	Firefield Tactical 10-40x50 Ta Black                                                                 
4NBUN7NBL0010	Sightmark CJRK Tactical Rifles Black                                                                 
4NC86RFCB0010	NFL Speed Replica Full Size He Cowboys                                                               
4NCOERPCAS080	Itasca Swampwalker 400 Camo 8                                                                        
4NCP8UBLUALRG	35x46 Super Value Pet Bed By M Blue Large                                                            
4NDG4C0000010	LM - Mini Stepper with Handles                                                                       
4NE4IQBLBASML	Swivel-Swirl Heavy Cable Knitted Fas Light Blue SM                                                   
4NE5XONBLAMED	PETMAKER Medium 2 Door Foldabl Black Medium                                                          
4NEQ3LAYRASML	Touchdog Quantum-Ice Full-Bodied Adj Red, Charc SM                                                   
4NFU0ZNC40010	PAW Cozy Cave Enclosed Cube Pe Coffee                                                                
4NG2RCGRN0010	Colt Ultrasonic 10,000 ct 6mm  Green                                                                 
4NGNBLNBL0010	Coleman 5HP Outboard Motor Black                                                                     
4NGNBLNBL0010	Coleman 5HP Outboard Motor Black                                                                     
4NHAK9VKP0010	Black Royal Flush Poker Pool S Black-Purple                                                          
4NHKYX0000010	Stalwart 12 Volt Electric Blan                                                                       
4NHUHV0000010	Duck Covers Double Defender SU                                                                       
4NHUIK0000010	Duck Covers Weather Defender P                                                                       
4NHWF40000010	Jump Starter and Air Compresso                                                                       
4NIGKXRED0010	Alcove pet cave bed- Red                                                                             
4NJBN2VPRAXLG	Womens Thermo Slimming Detox P Purple X Large                                                        
4NJBN4YELWOFM	Thermoslim Detox T-Shirt Yellow One Size Fits Most                                                   
4NJBN4YELWOFM	Thermoslim Detox T-Shirt Yellow One Size Fits Most                                                   
4NJBONREDAXLG	Womens Thermo Slimming Detox P Red X Large                                                           
4NJD2N0000010	Yoga Beginners Kit (Blue)                                                                            
4NJD6SNBL0010	Torpedo 105X Vortex Air Rifle Black                                                                  
4NJSR2NBL0010	Kunitza Black                                                                                        
4NJSRR0000010	Galileo 700mm x 60mm SmartScop                                                                       
4NJTMXNBL0010	CRUNCH 4" Coaxial 150 Watts Sp Black                                                                 
4NJWXI0000010	Birchwood Manor Thermo-Kitty H                                                                       
4NK6N0NEX0010	alcove wooden pet stairs Espresso                                                                    
4NKWAW0000010	Surf Van Pintail Skateboard                                                                          
4NL77A0000010	Golds Gym Ab Firm Pro                                                                                
4NL9LINWH0010	Caddis Rapid Shelter Sidewall  White                                                                 
4NLN1L0000010	Total Gym 1400                                                                                       
4NLNV8NWH0010	Airwheel S6 Smart Scooter White                                                                      
4NLOBW0000010	Emergency 2 Person Outdoor Sur                                                                       
4NLVPGNBL0010	Mens 4-Dimensional Bike Shorts Black                                                                 
4NMX8C0000010	Quadgear ATV Seat Cover- Camo,                                                                       
4NMYHMBLU0010	Upper Bounce 40" Mini Foldabl Blue                                                                   
4NN25N0000010	Boss Elite 320-Watt DVD 6.2" T                                                                       
4NN25Y0000010	Boss Elite Double-DIN DVD Play                                                                       
4NN25Y0000010	Boss Elite Double-DIN DVD Play                                                                       
4NN51X0000010	Avgo Car Dash Camera                                                                                 
4NNDGNBLU0010	Bestway Hydro-Splash FunDive M Blue                                                                  
4NNDGONGR0010	Bestway Hydro-Pro Dual Lens Di Gray                                                                  
4NOG3J0000010	DieHard Gold 250-Amp Wheeled Battery Charger & Eng                                                   
4NS9690000010	83pc Car Care Kit                                                                                    
4PE4070000010	Razor A-Scooter Pink                                                                                 
4PE6270000010	Pet Gear Easy Step Pet Stairs                                                                        
4PX135000KA05	Chicago Rink Skate Ladies Adult 5                                                                    
4PX135000KA08	Chicago Rink Skate Ladies Adult 8                                                                    
4PX135000KA10	Chicago Rink Skate Ladies Adult10                                                                    
4PX145000KA10	Chicago Rink Skate Mens Adult10                                                                      
4PX147000KA01	Chicago Rink Skate Girls 1                                                                           
4QB152NBRS100	Itasca Ketchikan - camo Pack Boot Brown 10                                                           
4QP567FPK0010	NFL Heavy Duty Vinyl Car Mats Packers                                                                
4QR7610000010	Crosman 357 Revolver Pistol                                                                          
4RF3730000010	Pet Gazebo 5' x 5' x 5'                                                                              
4RF3730000010	Pet Gazebo 5' x 5' x 5'                                                                              
4RF3730000010	Pet Gazebo 5' x 5' x 5'                                                                              
4RW084NML0010	Cat Life Lounger/Play Tree Multi                                                                     
4SL9960000010	2 ton Trolley Jack and Stand                                                                         
4SS0860000010	Weslo Cadence G 5.9                                                                                  
4TJ2260000010	CAN OBDII Diagnostic Scan Tool                                                                       
4UA727000S130	Itasca Fortitude IV Real Tree  13                                                                    
4UM345MSL0010	Sunny Climbing Stepper Silver                                                                        
4UT2960000010	Slendertone Abs6 Abdominal Ton                                                                       
4F87480000010	Little Tikes TotSports Basketb                                                                       
4NA01U0000010	Orbeez Ultimate Soothing Spa                                                                         
4NBDVU0000010	FP Harley Davidson Cruiser                                                                           
4NBDVU0000010	FP Harley Davidson Cruiser                                                                           
4NCTMR0000010	CIS-990 Huge 1:10 scale truck in Blue                                                                
4NFIFM0000010	Little Princess 18in Doll Vani                                                                       
4NHC480000010	Toysmith Newton's Cradle Physi                                                                       
4NHC9R0000010	OWI Kingii Dragon Artificial I                                                                       
4NHO9Y0000010	Bosch Circular Saw                                                                                   
4NI4HN0000010	Girls Dune Racer                                                                                     
4NI4HN0000010	Girls Dune Racer                                                                                     
4NI4HN0000010	Girls Dune Racer                                                                                     
4NI4HN0000010	Girls Dune Racer                                                                                     
4NI4HN0000010	Girls Dune Racer                                                                                     
4NI4HN0000010	Girls Dune Racer                                                                                     
4NI4HN0000010	Girls Dune Racer                                                                                     
4NI4HN0000010	Girls Dune Racer                                                                                     
4NI4HN0000010	Girls Dune Racer                                                                                     
4NI4HN0000010	Girls Dune Racer                                                                                     
4NI4HN0000010	Girls Dune Racer                                                                                     
4NI4JWNCL0010	BLAZE MONSTER TRUCK Clear                                                                            
4NI4JWNCL0010	BLAZE MONSTER TRUCK Clear                                                                            
4NJ09LNCL0010	DCSHG BT GRL ACT DL Clear                                                                            
4NJ0GI0000010	Cabbage Patch Baby So Real - Brunette                                                                
4NJ0L50000010	Breyers Classic Country Stable                                                                       
4NJ0L60000010	Breyer Stablemates Deluxe Animal Hospital                                                            
4NJIKV0000010	Alex Brands Knot A Quilt Patte                                                                       
4NKUOY0000010	TMNT Half Shell Headquarters                                                                         
4NLF230000010	Smithsonian Museum Craft Kit-                                                                        
4NLNQD0000010	PlayWheels Disney Princess Kid                                                                       
4NLVQ4NBL0010	CIS-107-C2 2MP camera quad wit Black                                                                 
4NMC470000010	Deluxe Cruisin Wagon                                                                                 
4NMC470000010	Deluxe Cruisin Wagon                                                                                 
4NMC4X0000010	Cozy Coupe                                                                                           
4NN1O80000010	Set of 2 Fashion Dolls with 7                                                                        
4NN25M0000010	Meccano Tech MAX Robot                                                                               
4NN2R40000010	Shimmer 'n Sparkle Ultimate Ma                                                                       
4NN2T10000010	TMNT Turtle Trash Truck                                                                              
4NN36U0000010	Kimball Kids Baby Grand Piano                                                                        
4NN3PL0000010	Kimball Kids Tabletop Air Hockey                                                                     
4NN4KA0000010	GWP Madame Alexander Eyewear A                                                                       
4NN51M0000010	Mebo 2.0 Robot                                                                                       
4NN5AT0000010	Hot Wheels ROTO REVOLUATION TR                                                                       
4NN5AU0000010	Hot Wheels SUPER ULTIMATE GARA                                                                       
4NN5N40000010	Monster High VAMPIRE KITCHEN P                                                                       
4NN5OP0000010	THOMAS & FRIENDS SUPER STATION                                                                       
4NN5PS0000010	KAMIGAMI SCARRAX ROBOT                                                                               
4NN5QJ0000010	Little Sprouts Academy Playset                                                                       
4NN5QZNWH0010	WebRC XDrone Spy 2 White                                                                             
4NN6NBBLU0010	NER RIVAL NEMESIS AST Blue                                                                           
4NN6O50000010	FRR ROARIN TYLER THE PLAYFUL T                                                                       
4NN6PH0000010	SPD MEGA CITY PLAYSET                                                                                
4NNB2C0000010	Huffy Disney Cars 16" Bike wit                                                                       
4NNBFKRED0010	My 1st Remote Control GoGo Fir Red                                                                   
4NNENBNML0010	Amav Multi-Color Slush Machine Multi                                                                 
4NNY2A0000010	LEGO DUPLO Cars Piston Cup R                                                                         
4NNY2H0000010	LEGO Star WarsTracker I 7518                                                                         
4NNY3A0000010	LEGO Juniors Lightning McQuee                                                                        
4NOB5L0000010	Spiderman Super Web Slinger                                                                          
4NOCGM0000010	TMNT Lights  & Sounds Trike                                                                          
4NODZ2RPK0010	Huffy N'Style 16" Bike Pink                                                                          
4NOOM80000010	Created by Me - Flower Fleece                                                                        
4QB8950000010	Fisher Price Pwr Whls LilHarly                                                                       
4RF9570000010	6V Lil Patrol Pink / Purple                                                                          
4RF9570000010	6V Lil Patrol Pink / Purple                                                                          
4RF9650000010	6V Lil Patrol Black / White                                                                          
4RS9360000010	FP Jeep Wrangler                                                                                     
4RS9360000010	FP Jeep Wrangler                                                                                     
4RS9360000010	FP Jeep Wrangler                                                                                     
4RS9360000010	FP Jeep Wrangler                                                                                     
4SA2850000010	Fire Chief Role Play Costume                                                                         
4SS134RPK0010	Princess Cozy Coupe Pink                                                                             
4UP9700000010	Lightning - Go Cart, Race Gree                                                                       
4UQ2140000010	Mattel Barbie New Dream house                                                                        
4NK04H0000010	PS4 Elder Scrolls V Skyrim SE                                                                        
4NK04H0000010	PS4 Elder Scrolls V Skyrim SE                                                                        
4NKWNU0000010	PS4 Injustice 2                                                                                      
4NKWYQ0000010	XB1 Tekken 7                                                                                         
4NLZKO0000010	PS4 Witcher Wild Hunt Complete                                                                       
4NM8IK0000010	Switch Console w Gray JoyCon                                                                         
4NM8IL0000010	Switch Joy Con Charging Grip                                                                         
4NME3F0000010	PS4 MLB 17 The Show                                                                                  
4NMX2X0000010	PS4 Marvel vs Capcom Infinite                                                                        
4NN3P10000010	PS4 Star Wars Battlefront II                                                                         
4NN3QB0000010	XB1 Call of Duty: WWII                                                                               
4NN52Q0000010	PS4 NBA 2K18                                                                                         
4NN54L0000010	Switch Troll & I                                                                                     
4NNAV00000010	Switch Mario Kart 8 Deluxe                                                                           
4NOB3C0000010	PS4 WWE 2K18                                                                                         
4NOB460000010	PS4 Just Dance 2018                                                                                  
4NOB6A0000010	PS4 Assassins Creed Origins                                                                          
4NOHJ50000010	Switch RBI Baseball 2017                                                                             
4UL8790000010	XB1 LEGO Marvels Avengers                                                                            